a bung|xa a bung
a doi|xa a doi
a dok|xa a dok
a luoi|thi tran a luoi
a lu|xa a lu
a mu sung|xa a mu sung
a ngo|xa a ngo
a nong|xa a nong
a roang|xa a roang
a rooi|xa a rooi
a tieng|xa a tieng
a ting|xa a ting
a vao|xa a vao
a vuong|xa a vuong
a xan|xa a xan
ai nghia|thi tran ai nghia
ai quoc|phuong ai quoc
ai quoc|xa ai quoc
ai thuong|xa ai thuong
ai tu|thi tran ai tu
al ba|xa al ba
am ha|xa am ha
an ap|xa an ap
an bai|thi tran an bai
an ba|xa an ba
an bien|phuong an bien
an binh a|phuong an binh a
an binh b|phuong an binh b
an binh tay|xa an binh tay
an binh|phuong an binh
an binh|xa an binh
an cau|xa an cau
an chan|xa an chan
an chau|thi tran an chau
an chau|xa an chau
an co|xa an co
an cuu|phuong an cuu
an cu|phuong an cu
an cu|xa an cu
an dan|xa an dan
an dao|xa an dao
an dien|xa an dien
an dinh|xa an dinh
an dong|phuong an dong
an dong|xa an dong
an don|phuong an don
an do|xa an do
an duc|xa an duc
an dung|xa an dung
an duong|phuong an duong
an duong|thi tran an duong
an duong|xa an duong
an hai bac|phuong an hai bac
an hai dong|phuong an hai dong
an hai tay|phuong an hai tay
an hai|xa an hai
an hao dong|xa an hao dong
an hao tay|xa an hao tay
an hao|xa an hao
an ha|xa an ha
an hiep|xa an hiep
an hoa hai|xa an hoa hai
an hoa tay|xa an hoa tay
an hoa thinh|xa an hoa thinh
an hoa|phuong an hoa
an hoa|xa an hoa
an hoi|phuong an hoi
an hong|xa an hong
an hung|phuong an hung
an hung|xa an hung
an huu|xa an huu
an khang|xa an khang
an khanh|phuong an khanh
an khanh|xa an khanh
an khe|phuong an khe
an khe|xa an khe
an khuong|xa an khuong
an lac a|phuong an lac a
an lac tay|xa an lac tay
an lac thon|thi tran an lac thon
an lac|phuong an lac
an lac|xa an lac
an lam|xa an lam
an lao|thi tran an lao
an lao|xa an lao
an lap|xa an lap
an le|xa an le
an linh|xa an linh
an loc|phuong an loc
an loi dong|phuong an loi dong
an long|xa an long
an luc long|xa an luc long
an luong|xa an luong
an luu|phuong an luu
an lu|xa an lu
an minh bac|xa an minh bac
an my|phuong an my
an my|xa an my
an ngai tay|xa an ngai tay
an ngai trung|xa an ngai trung
an ngai|xa an ngai
an nghia|xa an nghia
an nghiep|phuong an nghiep
an nghiep|xa an nghiep
an nhon tay|xa an nhon tay
an nhon|xa an nhon
an nhut|xa an nhut
an ninh dong|xa an ninh dong
an ninh tay|xa an ninh tay
an ninh|xa an ninh
an noi|xa an noi
an nong|xa an nong
an phong|xa an phong
an phu dong|phuong an phu dong
an phu tan|xa an phu tan
an phu tay|xa an phu tay
an phu thuan|xa an phu thuan
an phu trung|xa an phu trung
an phuc|xa an phuc
an phuoc|phuong an phuoc
an phuoc|xa an phuoc
an phuong|xa an phuong
an phu|phuong an phu
an phu|thi tran an phu
an phu|xa an phu
an quang huu|xa an quang huu
an quang|xa an quang
an qui|xa an qui
an quy|xa an quy
an sinh|phuong an sinh
an sinh|xa an sinh
an son|phuong an son
an son|xa an son
an tan|phuong an tan
an tan|xa an tan
an tao|phuong an tao
an tay|phuong an tay
an tay|xa an tay
an thach|xa an thach
an thai dong|xa an thai dong
an thai trung|xa an thai trung
an thai|xa an thai
an thang|xa an thang
an thanh 1|xa an thanh 1
an thanh 2|xa an thanh 2
an thanh 3|xa an thanh 3
an thanh dong|xa an thanh dong
an thanh nam|xa an thanh nam
an thanh tay|xa an thanh tay
an thanh thuy|xa an thanh thuy
an thanh trung|xa an thanh trung
an thanh|phuong an thanh
an thanh|xa an thanh
an thinh|xa an thinh
an thi|thi tran an thi
an thoi dong|xa an thoi dong
an thoi|phuong an thoi
an thoi|thi tran an thoi
an thoi|xa an thoi
an tho|xa an tho
an thuan|xa an thuan
an thuong|xa an thuong
an thuy|xa an thuy
an tien|xa an tien
an tinh|phuong an tinh
an tin|xa an tin
an toan|xa an toan
an trach a|xa an trach a
an trach|xa an trach
an trang|xa an trang
an trung|xa an trung
an truong a|xa an truong a
an truong|xa an truong
an tuc|xa an tuc
an tuong dong|xa an tuong dong
an tuong tay|xa an tuong tay
an tuong|phuong an tuong
an tuong|xa an tuong
an vien|xa an vien
an vinh ngai|xa an vinh ngai
an vinh|xa an vinh
an vi|xa an vi
an vu|xa an vu
an xuan|phuong an xuan
an xuan|xa an xuan
an xuyen|xa an xuyen
ang cang|xa ang cang
ang nua|xa ang nua
ang to|xa ang to
anh dung|phuong anh dung
anh son|thi tran anh son
anh son|xa anh son
au co|phuong au co
au lau|xa au lau
ayun ha|xa ayun ha
ba bich|xa ba bich
ba che|thi tran ba che
ba chuc|thi tran ba chuc
ba cum bac|xa ba cum bac
ba cum nam|xa ba cum nam
ba cung|xa ba cung
ba diem|xa ba diem
ba dien|xa ba dien
ba dinh|phuong ba dinh
ba dinh|xa ba dinh
ba dong|xa ba dong
ba don|phuong ba don
ba giang|xa ba giang
ba hang doi|thi tran ba hang doi
ba hang|phuong ba hang
ba hien|thi tran ba hien
ba kham|xa ba kham
ba lang|phuong ba lang
ba le|xa ba le
ba lien|xa ba lien
ba long|xa ba long
ba nam|xa ba nam
ba nang|xa ba nang
ba ngac|xa ba ngac
ba ngoi|phuong ba ngoi
ba sao|thi tran ba sao
ba sao|xa ba sao
ba tang|xa ba tang
ba thanh|xa ba thanh
ba tieu|xa ba tieu
ba to|thi tran ba to
ba to|xa ba to
ba trai|xa ba trai
ba trang|xa ba trang
ba trieu|phuong ba trieu
ba trinh|xa ba trinh
ba tri|thi tran ba tri
ba vinh|xa ba vinh
ba vi|xa ba vi
ba xa|xa ba xa
ba xuyen|xa ba xuyen
bac an|xa bac an
bac binh|xa bac binh
bac cuong|phuong bac cuong
bac hai|xa bac hai
bac ha|phuong bac ha
bac ha|thi tran bac ha
bac hoa|xa bac hoa
bac hong|phuong bac hong
bac hong|xa bac hong
bac hung|xa bac hung
bac lang|xa bac lang
bac la|xa bac la
bac lenh|phuong bac lenh
bac lung|xa bac lung
bac luong|xa bac luong
bac ly|phuong bac ly
bac ly|xa bac ly
bac nghia|phuong bac nghia
bac phong|xa bac phong
bac phu|xa bac phu
bac quynh|xa bac quynh
bac ruong|xa bac ruong
bac son|phuong bac son
bac son|thi tran bac son
bac son|xa bac son
bac thanh|xa bac thanh
bac thuy|xa bac thuy
bac trach|xa bac trach
bac viet|xa bac viet
bac xa|xa bac xa
bac yen|thi tran bac yen
bach dang|phuong bach dang
bach dang|xa bach dang
bach dich|xa bach dich
bach hac|phuong bach hac
bach ha|xa bach ha
bach khoa|phuong bach khoa
bach long|xa bach long
bach luu|xa bach luu
bach mai|phuong bach mai
bach ngoc|xa bach ngoc
bach quang|phuong bach quang
bach sam|phuong bach sam
bach thuan|xa bach thuan
bach thuong|phuong bach thuong
bach xa|xa bach xa
bai bong|phuong bai bong
bai chay|phuong bai chay
bai say|xa bai say
bai son|xa bai son
bai thom|xa bai thom
bai tranh|xa bai tranh
ban bo|xa ban bo
ban cai|xa ban cai
ban cam|xa ban cam
ban cong|xa ban cong
ban dat|xa ban dat
ban diu|xa ban diu
ban giang|xa ban giang
ban gian|xa ban gian
ban hon|xa ban hon
ban ho|xa ban ho
ban lam|xa ban lam
ban lang|xa ban lang
ban lau|xa ban lau
ban lien|xa ban lien
ban long|xa ban long
ban luoc|xa ban luoc
ban may|xa ban may
ban me|xa ban me
ban mu|xa ban mu
ban ngoai|xa ban ngoai
ban ngo|xa ban ngo
ban nguyen|xa ban nguyen
ban nhung|xa ban nhung
ban phiet|xa ban phiet
ban pho|xa ban pho
ban phung|xa ban phung
ban qua|xa ban qua
ban ria|xa ban ria
ban sen|xa ban sen
ban tan dinh|xa ban tan dinh
ban thach|xa ban thach
ban thi|xa ban thi
ban vuoc|xa ban vuoc
ban xeo|xa ban xeo
ban yen nhan|phuong ban yen nhan
bang a drenh|xa bang a drenh
bang an|xa bang an
bang ca|xa bang ca
bang coc|xa bang coc
bang doan|xa bang doan
bang gia|xa bang gia
bang hanh|xa bang hanh
bang huu|xa bang huu
bang lang|xa bang lang
bang la|phuong bang la
bang luan|xa bang luan
bang lung|thi tran bang lung
bang mac|xa bang mac
bang phuc|xa bang phuc
bang thanh|xa bang thanh
bang van|xa bang van
banh trach|xa banh trach
bao ai|xa bao ai
bao an|phuong bao an
bao binh|xa bao binh
bao cuong|xa bao cuong
bao dai|xa bao dai
bao dap|xa bao dap
bao ha|xa bao ha
bao hieu|xa bao hieu
bao hoa|xa bao hoa
bao hung|xa bao hung
bao khe|xa bao khe
bao lac|thi tran bao lac
bao lam|xa bao lam
bao la|xa bao la
bao linh|xa bao linh
bao ly|xa bao ly
bao nam|xa bao nam
bao nhai|xa bao nhai
bao ninh|xa bao ninh
bao quang|xa bao quang
bao son|xa bao son
bao thang|xa bao thang
bao thanh|xa bao thanh
bao thuan|xa bao thuan
bao toan|xa bao toan
bao vinh|phuong bao vinh
bao yen|xa bao yen
bar maih|xa bar maih
bat dai son|xa bat dai son
bat mot|xa bat mot
bat trang|xa bat trang
bat xat|thi tran bat xat
bau can|xa bau can
bau chinh|xa bau chinh
bau don|xa bau don
bau ham 2|xa bau ham 2
bau ham|xa bau ham
bau lam|xa bau lam
bau nang|xa bau nang
bau sen|phuong bau sen
bau tram|xa bau tram
bay ngan|thi tran bay ngan
be van dan|xa be van dan
ben cau|thi tran ben cau
ben cui|xa ben cui
ben got|phuong ben got
ben luc|thi tran ben luc
ben nghe|phuong ben nghe
ben quan|thi tran ben quan
ben sung|thi tran ben sung
ben tam|phuong ben tam
ben thanh|phuong ben thanh
ben thuy|phuong ben thuy
bha le|xa bha le
bich dao|phuong bich dao
bich dong|thi tran bich dong
bich hoa|xa bich hoa
bien bach dong|xa bien bach dong
bien bach|xa bien bach
bien dong|xa bien dong
bien giang|phuong bien giang
bien gioi|xa bien gioi
bien ho|xa bien ho
bien son|xa bien son
binh an|phuong binh an
binh an|xa binh an
binh ba|xa binh ba
binh chanh|xa binh chanh
binh chau|xa binh chau
binh chieu|phuong binh chieu
binh chuan|phuong binh chuan
binh chuan|xa binh chuan
binh chuong|xa binh chuong
binh dai|thi tran binh dai
binh dan|xa binh dan
binh dao|xa binh dao
binh da|phuong binh da
binh dinh bac|xa binh dinh bac
binh dinh nam|xa binh dinh nam
binh dinh|phuong binh dinh
binh dinh|xa binh dinh
binh dong|xa binh dong
binh duc|phuong binh duc
binh duc|xa binh duc
binh duong|thi tran binh duong
binh duong|xa binh duong
binh giang|xa binh giang
binh giao|xa binh giao
binh gia|thi tran binh gia
binh gia|xa binh gia
binh hai|xa binh hai
binh hang tay|xa binh hang tay
binh hang trung|xa binh hang trung
binh han|phuong binh han
binh hem|xa binh hem
binh hien|phuong binh hien
binh hiep|xa binh hiep
binh hoa bac|xa binh hoa bac
binh hoa dong|xa binh hoa dong
binh hoa hung|xa binh hoa hung
binh hoa nam|xa binh hoa nam
binh hoa phuoc|xa binh hoa phuoc
binh hoa tay|xa binh hoa tay
binh hoa trung|xa binh hoa trung
binh hoa|phuong binh hoa
binh hoa|xa binh hoa
binh hung hoa a|phuong binh hung hoa a
binh hung hoa b|phuong binh hung hoa b
binh hung hoa|phuong binh hung hoa
binh hung|phuong binh hung
binh hung|xa binh hung
binh khanh|phuong binh khanh
binh khanh|xa binh khanh
binh khe|xa binh khe
binh khuong|xa binh khuong
binh kien|xa binh kien
binh kieu|xa binh kieu
binh lam|xa binh lam
binh lang|xa binh lang
binh lanh|xa binh lanh
binh la|xa binh la
binh lieu|thi tran binh lieu
binh loc|xa binh loc
binh loi|xa binh loi
binh long|xa binh long
binh luong|xa binh luong
binh lu|xa binh lu
binh minh|phuong binh minh
binh minh|thi tran binh minh
binh minh|xa binh minh
binh my|thi tran binh my
binh my|xa binh my
binh nam|xa binh nam
binh nghia|xa binh nghia
binh nghi|xa binh nghi
binh ngoc|phuong binh ngoc
binh ngoc|xa binh ngoc
binh nguyen|xa binh nguyen
binh nham|phuong binh nham
binh nhan|xa binh nhan
binh nhi|xa binh nhi
binh ninh|xa binh ninh
binh phan|xa binh phan
binh phong thanh|thi tran binh phong thanh
binh phuc nhut|xa binh phuc nhut
binh phuc|xa binh phuc
binh phuoc xuan|xa binh phuoc xuan
binh phuoc|xa binh phuoc
binh phu|xa binh phu
binh que|xa binh que
binh quoi|xa binh quoi
binh quy|xa binh quy
binh san|phuong binh san
binh sa|xa binh sa
binh son|xa binh son
binh tam|xa binh tam
binh tan phu|xa binh tan phu
binh tan|phuong binh tan
binh tan|xa binh tan
binh thang|phuong binh thang
binh thang|xa binh thang
binh thanh dong|xa binh thanh dong
binh thanh trung|xa binh thanh trung
binh thanh|phuong binh thanh
binh thanh|xa binh thanh
binh thoi|xa binh thoi
binh tho|phuong binh tho
binh thuan|phuong binh thuan
binh thuan|xa binh thuan
binh thuy|phuong binh thuy
binh thuy|xa binh thuy
binh tien|xa binh tien
binh tinh|xa binh tinh
binh tri dong a|phuong binh tri dong a
binh tri dong b|phuong binh tri dong b
binh tri dong|phuong binh tri dong
binh trieu|xa binh trieu
binh trinh dong|xa binh trinh dong
binh tri|xa binh tri
binh trung dong|phuong binh trung dong
binh trung tay|phuong binh trung tay
binh trung|xa binh trung
binh tuong|xa binh tuong
binh tu|xa binh tu
binh van|xa binh van
binh xa|xa binh xa
binh xuan|xa binh xuan
binh xuyen|xa binh xuyen
binh yen|xa binh yen
bo de|phuong bo de
bo de|xa bo de
bo ha|thi tran bo ha
bo ly|xa bo ly
bo muoi|xa bo muoi
bo ngoong|xa bo ngoong
bo sao|xa bo sao
bo sinh|xa bo sinh
bo xuyen|phuong bo xuyen
bo y|xa bo y
boc bo|xa boc bo
boc nhieu|xa boc nhieu
boi cau|xa boi cau
boi son|xa boi son
bok toi|xa bok toi
bom bo|xa bom bo
bon phang|xa bon phang
bong khe|xa bong khe
bong krang|xa bong krang
bong lai|xa bong lai
bong son|phuong bong son
bong trang|xa bong trang
bot xuyen|xa bot xuyen
bu gia map|xa bu gia map
bu nho|xa bu nho
bui huu nghia|phuong bui huu nghia
bui la nhan|xa bui la nhan
bui thi xuan|phuong bui thi xuan
bum nua|xa bum nua
bum to|xa bum to
bung lao|xa bung lao
bung rieng|xa bung rieng
bung tau|thi tran bung tau
buon choah|xa buon choah
buon trap|thi tran buon trap
buon tria|xa buon tria
buon triet|xa buon triet
but son|thi tran but son
buu hoa|phuong buu hoa
buu long|phuong buu long
ca dinh|xa ca dinh
ca dy|xa ca dy
ca lui|xa ca lui
ca nang|xa ca nang
ca na|xa ca na
ca thanh|xa ca thanh
cac son|xa cac son
cach bi|xa cach bi
cach linh|xa cach linh
cai be|thi tran cai be
cai bo|xa cai bo
cai chien|xa cai chien
cai dan|phuong cai dan
cai dau|thi tran cai dau
cai doi vam|thi tran cai doi vam
cai khe|phuong cai khe
cai kinh|xa cai kinh
cai nhum|thi tran cai nhum
cai nuoc|thi tran cai nuoc
cai rong|thi tran cai rong
cai tac|thi tran cai tac
cai tau ha|thi tran cai tau ha
cai vien|xa cai vien
cai von|phuong cai von
cam an bac|xa cam an bac
cam an nam|xa cam an nam
cam an|phuong cam an
cam an|xa cam an
cam binh|phuong cam binh
cam binh|xa cam binh
cam chau|phuong cam chau
cam chau|xa cam chau
cam che|xa cam che
cam chinh|xa cam chinh
cam con|xa cam con
cam dan|xa cam dan
cam dien|xa cam dien
cam doai|xa cam doai
cam dong|phuong cam dong
cam dong|xa cam dong
cam duc|thi tran cam duc
cam due|xa cam due
cam duong|xa cam duong
cam giang|thi tran cam giang
cam giang|xa cam giang
cam gia|phuong cam gia
cam hai dong|xa cam hai dong
cam hai tay|xa cam hai tay
cam hai|xa cam hai
cam ha|xa cam ha
cam hiep bac|xa cam hiep bac
cam hiep nam|xa cam hiep nam
cam hieu|xa cam hieu
cam hoang|xa cam hoang
cam hoa|xa cam hoa
cam hung|xa cam hung
cam khe|thi tran cam khe
cam kim|xa cam kim
cam lac|xa cam lac
cam lam|xa cam lam
cam lap|xa cam lap
cam la|xa cam la
cam lien|xa cam lien
cam linh|phuong cam linh
cam linh|xa cam linh
cam loc|phuong cam loc
cam loc|xa cam loc
cam loi|phuong cam loi
cam long|xa cam long
cam lo|thi tran cam lo
cam luong|xa cam luong
cam ly|xa cam ly
cam minh|xa cam minh
cam muon|xa cam muon
cam my|xa cam my
cam nam|phuong cam nam
cam nghia|phuong cam nghia
cam nghia|xa cam nghia
cam ngoc|xa cam ngoc
cam nhan|xa cam nhan
cam nhuong|xa cam nhuong
cam ninh|xa cam ninh
cam pho|phuong cam pho
cam phuc bac|phuong cam phuc bac
cam phuc nam|phuong cam phuc nam
cam phuc|xa cam phuc
cam phuoc dong|xa cam phuoc dong
cam phuoc tay|xa cam phuoc tay
cam phu|phuong cam phu
cam phu|xa cam phu
cam quang|xa cam quang
cam quan|xa cam quan
cam quy|xa cam quy
cam son|phuong cam son
cam son|xa cam son
cam tam|xa cam tam
cam tan|xa cam tan
cam tay|phuong cam tay
cam thach|phuong cam thach
cam thach|xa cam thach
cam thanh bac|xa cam thanh bac
cam thanh nam|xa cam thanh nam
cam thanh|phuong cam thanh
cam thanh|xa cam thanh
cam thinh dong|xa cam thinh dong
cam thinh tay|xa cam thinh tay
cam thinh|phuong cam thinh
cam thinh|xa cam thinh
cam thuan|phuong cam thuan
cam thuong|phuong cam thuong
cam thuong|xa cam thuong
cam thuy|phuong cam thuy
cam thuy|xa cam thuy
cam trung|phuong cam trung
cam trung|xa cam trung
cam tuyen|xa cam tuyen
cam tu|xa cam tu
cam van|xa cam van
cam vinh|xa cam vinh
cam vu|xa cam vu
cam xa|xa cam xa
cam xuyen|thi tran cam xuyen
cam yen|xa cam yen
can cau|xa can cau
can chu phin|xa can chu phin
can co|xa can co
can dang|xa can dang
can duoc|thi tran can duoc
can giuoc|thi tran can giuoc
can huu|xa can huu
can khe|xa can khe
can kiem|xa can kiem
can nong|xa can nong
can thanh|thi tran can thanh
can ty|xa can ty
can yen|xa can yen
cang long|thi tran cang long
canh duong|xa canh duong
canh hien|xa canh hien
canh hiep|xa canh hiep
canh hoa|xa canh hoa
canh hung|xa canh hung
canh lien|xa canh lien
canh nang|thi tran canh nang
canh nau|xa canh nau
canh tan|xa canh tan
canh thuan|xa canh thuan
canh thuy|xa canh thuy
canh vinh|xa canh vinh
cao an|xa cao an
cao bo|xa cao bo
cao chuong|xa cao chuong
cao dai|xa cao dai
cao duc|xa cao duc
cao duong|xa cao duong
cao ky|xa cao ky
cao lau|xa cao lau
cao loc|thi tran cao loc
cao ma po|xa cao ma po
cao minh|xa cao minh
cao ngan|xa cao ngan
cao ngoc|xa cao ngoc
cao nhan|xa cao nhan
cao pha|xa cao pha
cao phong|thi tran cao phong
cao phong|xa cao phong
cao quang|xa cao quang
cao son|xa cao son
cao tan|xa cao tan
cao thang|phuong cao thang
cao thang|xa cao thang
cao thanh|xa cao thanh
cao thinh|xa cao thinh
cao thuong|thi tran cao thuong
cao thuong|xa cao thuong
cao vien|xa cao vien
cao xanh|phuong cao xanh
cao xa|xa cao xa
cap dan|xa cap dan
cap tien|xa cap tien
cat ba|thi tran cat ba
cat bi|phuong cat bi
cat chanh|xa cat chanh
cat dai|phuong cat dai
cat hai|thi tran cat hai
cat hai|xa cat hai
cat hanh|xa cat hanh
cat hiep|xa cat hiep
cat hung|xa cat hung
cat khanh|xa cat khanh
cat lai|phuong cat lai
cat lam|xa cat lam
cat linh|phuong cat linh
cat minh|xa cat minh
cat ne|xa cat ne
cat nhon|xa cat nhon
cat que|xa cat que
cat son|xa cat son
cat tai|xa cat tai
cat tan|xa cat tan
cat thang|xa cat thang
cat thanh|thi tran cat thanh
cat thanh|xa cat thanh
cat thinh|xa cat thinh
cat tien|thi tran cat tien
cat tien|xa cat tien
cat trinh|xa cat trinh
cat tuong|xa cat tuong
cat van|xa cat van
cau ba|xa cau ba
cau dat|phuong cau dat
cau den|phuong cau den
cau dien|phuong cau dien
cau giat|thi tran cau giat
cau ke|thi tran cau ke
cau khoi|xa cau khoi
cau kho|phuong cau kho
cau loc|xa cau loc
cau may|phuong cau may
cau ngang|thi tran cau ngang
cau ong lanh|phuong cau ong lanh
cau quan|thi tran cau quan
cau thia|phuong cau thia
cau tre|phuong cau tre
cay duong|thi tran cay duong
cay gao|xa cay gao
cay thi|xa cay thi
cay truong ii|xa cay truong ii
cha cang|xa cha cang
cha la|xa cha la
cha nua|xa cha nua
cha to|xa cha to
cha val|xa cha val
chan hung|xa chan hung
chan ly|xa chan ly
chan mong|xa chan mong
chan nua|xa chan nua
chan son|xa chan son
chan thinh|xa chan thinh
chang son|xa chang son
chanh an|xa chanh an
chanh lo|phuong chanh lo
chanh my|phuong chanh my
chanh nghia|phuong chanh nghia
chanh phu hoa|phuong chanh phu hoa
chat binh|xa chat binh
chau binh|xa chau binh
chau can|xa chau can
chau cuong|xa chau cuong
chau dien|xa chau dien
chau dinh|xa chau dinh
chau giang|phuong chau giang
chau hanh|xa chau hanh
chau hoan|xa chau hoan
chau hoa|xa chau hoa
chau hoi|xa chau hoi
chau hong|xa chau hong
chau hung a|xa chau hung a
chau hung|thi tran chau hung
chau hung|xa chau hung
chau khanh|xa chau khanh
chau khe|phuong chau khe
chau khe|xa chau khe
chau kim|xa chau kim
chau lang|xa chau lang
chau loc|xa chau loc
chau ly|xa chau ly
chau minh|xa chau minh
chau nga|xa chau nga
chau nhan|xa chau nhan
chau o|thi tran chau o
chau pha|xa chau pha
chau phong|xa chau phong
chau phu a|phuong chau phu a
chau phu b|phuong chau phu b
chau quang|xa chau quang
chau que ha|xa chau que ha
chau que thuong|xa chau que thuong
chau son|phuong chau son
chau son|xa chau son
chau thai|xa chau thai
chau thang|xa chau thang
chau thanh|thi tran chau thanh
chau thanh|xa chau thanh
chau thoi|xa chau thoi
chau thon|xa chau thon
chau thuan|xa chau thuan
chau tien|xa chau tien
chau van liem|phuong chau van liem
che cu nha|xa che cu nha
che la|xa che la
che tao|xa che tao
cheo reo|phuong cheo reo
chi ca|xa chi ca
chi cong|xa chi cong
chi dam|xa chi dam
chi dao|xa chi dao
chi dong|thi tran chi dong
chi hoa|xa chi hoa
chi khe|xa chi khe
chi lang bac|xa chi lang bac
chi lang nam|xa chi lang nam
chi lang|phuong chi lang
chi lang|thi tran chi lang
chi lang|xa chi lang
chi minh|phuong chi minh
chi minh|xa chi minh
chi ne|thi tran chi ne
chi tan|xa chi tan
chi thanh|thi tran chi thanh
chi thao|xa chi thao
chi thiet|xa chi thiet
chi tien|xa chi tien
chi vien|xa chi vien
chien pho|xa chien pho
chien thang|xa chien thang
chieng an|phuong chieng an
chieng an|xa chieng an
chieng bang|xa chieng bang
chieng ban|xa chieng ban
chieng bom|xa chieng bom
chieng cang|xa chieng cang
chieng chan|xa chieng chan
chieng chau|xa chieng chau
chieng chung|xa chieng chung
chieng coi|phuong chieng coi
chieng cong|xa chieng cong
chieng co|xa chieng co
chieng den|xa chieng den
chieng dong|xa chieng dong
chieng en|xa chieng en
chieng hac|xa chieng hac
chieng hoa|xa chieng hoa
chieng ken|xa chieng ken
chieng khay|xa chieng khay
chieng kheo|xa chieng kheo
chieng khoang|xa chieng khoang
chieng khoa|xa chieng khoa
chieng khoi|xa chieng khoi
chieng khoong|xa chieng khoong
chieng khua|xa chieng khua
chieng khuong|xa chieng khuong
chieng lao|xa chieng lao
chieng la|xa chieng la
chieng le|phuong chieng le
chieng luong|xa chieng luong
chieng ly|xa chieng ly
chieng mai|xa chieng mai
chieng mung|xa chieng mung
chieng muon|xa chieng muon
chieng ngam|xa chieng ngam
chieng ngan|xa chieng ngan
chieng noi|xa chieng noi
chieng on|xa chieng on
chieng pac|xa chieng pac
chieng pan|xa chieng pan
chieng pha|xa chieng pha
chieng phung|xa chieng phung
chieng sai|xa chieng sai
chieng sang|xa chieng sang
chieng san|xa chieng san
chieng sinh|phuong chieng sinh
chieng sinh|xa chieng sinh
chieng son|xa chieng son
chieng so|xa chieng so
chieng sung|xa chieng sung
chieng tuong|xa chieng tuong
chieng ve|xa chieng ve
chieng xom|xa chieng xom
chieng xuan|xa chieng xuan
chieng yen|xa chieng yen
chieu luu|xa chieu luu
chieu vu|xa chieu vu
chieu yen|xa chieu yen
chim van|xa chim van
chinh gian|phuong chinh gian
chinh ly|xa chinh ly
chinh my|xa chinh my
chinh nghia|xa chinh nghia
cho chua|thi tran cho chua
cho chun|xa cho chun
cho chu|thi tran cho chu
cho gao|thi tran cho gao
cho lach|thi tran cho lach
cho lau|thi tran cho lau
cho long|xa cho long
cho moi|thi tran cho moi
cho ra|thi tran cho ra
cho vam|thi tran cho vam
chon thanh|thi tran chon thanh
chroh ponan|xa chroh ponan
chu a thai|xa chu a thai
chu a|xa chu a
chu bah|xa chu bah
chu dang ya|xa chu dang ya
chu dien|xa chu dien
chu don|xa chu don
chu drang|xa chu drang
chu gu|xa chu gu
chu hoa|xa chu hoa
chu hreng|xa chu hreng
chu huong|xa chu huong
chu kbo|xa chu kbo
chu krey|xa chu krey
chu minh|xa chu minh
chu mo|xa chu mo
chu ngoc|xa chu ngoc
chu phan|xa chu phan
chu pong|xa chu pong
chu prong|thi tran chu prong
chu rang|xa chu rang
chu rcam|xa chu rcam
chu se|thi tran chu se
chu trinh|xa chu trinh
chu ty|thi tran chu ty
chua hang|phuong chua hang
chuc son|thi tran chuc son
chung chai|xa chung chai
chuong duong|phuong chuong duong
chuong duong|xa chuong duong
chuong xa|xa chuong xa
chuyen my|xa chuyen my
chuyen ngoai|xa chuyen ngoai
co am|xa co am
co ba|xa co ba
co bi|xa co bi
co dam|xa co dam
co dong|xa co dong
co do|thi tran co do
co do|xa co do
co dung|xa co dung
co giang|phuong co giang
co le|thi tran co le
co linh|xa co linh
co loa|xa co loa
co lung|xa co lung
co ma|xa co ma
co ngan|xa co ngan
co nhue 1|phuong co nhue 1
co nhue 2|phuong co nhue 2
co noi|xa co noi
co phuc|thi tran co phuc
co thanh|phuong co thanh
co tong|xa co tong
co to|thi tran co to
co to|xa co to
coc dan|xa coc dan
coc lau|xa coc lau
coc leu|phuong coc leu
coc ly|xa coc ly
coc my|xa coc my
coc pai|thi tran coc pai
coc pang|xa coc pang
coc re|xa coc re
coc san|xa coc san
con cuong|thi tran con cuong
con lon|xa con lon
con minh|xa con minh
con thoi|xa con thoi
cong bang|xa cong bang
cong chinh|xa cong chinh
cong da|xa cong da
cong hai|xa cong hai
cong hien|xa cong hien
cong hoa|phuong cong hoa
cong hoa|xa cong hoa
cong lac|xa cong lac
cong liem|xa cong liem
cong ly|xa cong ly
cong son|xa cong son
cong thanh|xa cong thanh
cong vi|phuong cong vi
cu a mung|xa cu a mung
cu an|xa cu an
cu bao|xa cu bao
cu bi|xa cu bi
cu bong|xa cu bong
cu chi|thi tran cu chi
cu dlie m'nong|cu dlie mnong|xa cu dlie m'nong|cu dlie mnong
cu dong|xa cu dong
cu dram|xa cu dram
cu e wi|xa cu e wi
cu ebur|xa cu ebur
cu elang|xa cu elang
cu hue|xa cu hue
cu jang|xa cu jang
cu k roa|xa cu k roa
cu kbang|xa cu kbang
cu khe|xa cu khe
cu khoi|phuong cu khoi
cu klong|xa cu klong
cu knia|xa cu knia
cu kty|xa cu kty
cu lao dung|thi tran cu lao dung
cu le|xa cu le
cu m'gar|cu mgar|xa cu m'gar|cu mgar
cu m'lan|cu mlan|xa cu m'lan|cu mlan
cu m'ta|cu mta|xa cu m'ta|cu mta
cu mot|xa cu mot
cu nam|xa cu nam
cu ne|xa cu ne
cu ni|xa cu ni
cu pong|xa cu pong
cu prao|xa cu prao
cu prong|xa cu prong
cu pui|xa cu pui
cu san|xa cu san
cu sue|xa cu sue
cu thang|xa cu thang
cu van|xa cu van
cu yen|xa cu yen
cua bac|phuong cua bac
cua can|xa cua can
cua dai|phuong cua dai
cua dong|phuong cua dong
cua duong|xa cua duong
cua nam|phuong cua nam
cua ong|phuong cua ong
cua tung|thi tran cua tung
cua viet|thi tran cua viet
cuc duong|xa cuc duong
cuc phuong|xa cuc phuong
cun pheo|xa cun pheo
cung son|thi tran cung son
cuoi ha|xa cuoi ha
cuong chinh|xa cuong chinh
cuong gian|xa cuong gian
cuong loi|xa cuong loi
cuong son|xa cuong son
cuong thinh|xa cuong thinh
cuor dang|xa cuor dang
cuor knia|xa cuor knia
cuu an|xa cuu an
cuu cao|xa cuu cao
da bac|thi tran da bac
da bac|xa da bac
da chais|xa da chais
da don|xa da don
da do|xa da do
da k'nang|da knang|xa da k'nang|da knang
da kai|xa da kai
da kao|phuong da kao
da kho|xa da kho
da kia|xa da kia
da krong|xa da krong
da lay|xa da lay
da loan|xa da loan
da loc|xa da loc
da long|xa da long
da m'ri|da mri|thi tran da m'ri|da mri
da m'rong|da mrong|xa da m'rong|da mrong
da mai|phuong da mai
da mi|xa da mi
da nhim|xa da nhim
da oai|xa da oai
da pal|xa da pal
da phuc|phuong da phuc
da phuc|xa da phuc
da phuoc hoi|xa da phuoc hoi
da phuoc|xa da phuoc
da ploa|xa da ploa
da quyn|xa da quyn
da ron|xa da ron
da rsal|xa da rsal
da sar|xa da sar
da son|xa da son
da teh|thi tran da teh
da thong|xa da thong
da tong|xa da tong
da ton|xa da ton
da trach|xa da trach
da vi|xa da vi
dac pre|xa dac pre
dac pring|xa dac pring
dac son|xa dac son
dac so|xa dac so
dac toi|xa dac toi
dai an 1|xa dai an 1
dai an 2|xa dai an 2
dai ang|xa dai ang
dai an|xa dai an
dai bai|xa dai bai
dai ban|xa dai ban
dai binh|xa dai binh
dai chanh|xa dai chanh
dai cuong|xa dai cuong
dai dien|xa dai dien
dai dinh|thi tran dai dinh
dai dong thanh|xa dai dong thanh
dai dong|xa dai dong
dai duc|xa dai duc
dai hai|xa dai hai
dai ha|xa dai ha
dai hiep|xa dai hiep
dai hoa loc|xa dai hoa loc
dai hoa|xa dai hoa
dai hong|xa dai hong
dai hop|xa dai hop
dai hung|xa dai hung
dai kim|phuong dai kim
dai lai|xa dai lai
dai lam|xa dai lam
dai lanh|xa dai lanh
dai lao|xa dai lao
dai lich|xa dai lich
dai loc|xa dai loc
dai mach|xa dai mach
dai minh|xa dai minh
dai mo|phuong dai mo
dai nai|phuong dai nai
dai ngai|thi tran dai ngai
dai nghia|thi tran dai nghia
dai nghia|xa dai nghia
dai phac|xa dai phac
dai pham|xa dai pham
dai phong|xa dai phong
dai phuc|phuong dai phuc
dai phuc|xa dai phuc
dai phuoc|xa dai phuoc
dai phu|xa dai phu
dai quang|xa dai quang
dai sao|xa dai sao
dai son|phuong dai son
dai son|xa dai son
dai tam|xa dai tam
dai tan|xa dai tan
dai tap|xa dai tap
dai thang|xa dai thang
dai thanh|xa dai thanh
dai thinh|xa dai thinh
dai tien|xa dai tien
dai trach|xa dai trach
dai tu|xa dai tu
dai xuan|xa dai xuan
dai xuyen|xa dai xuyen
dai yen|phuong dai yen
dai yen|xa dai yen
dak ang|xa dak ang
dak bla|xa dak bla
dak blo|xa dak blo
dak buk so|xa dak buk so
dak cam|xa dak cam
dak choong|xa dak choong
dak djrang|xa dak djrang
dak doa|thi tran dak doa
dak drong|xa dak drong
dak dro|xa dak dro
dak duc|xa dak duc
dak gan|xa dak gan
dak glei|thi tran dak glei
dak ha|thi tran dak ha
dak ha|xa dak ha
dak hlo|xa dak hlo
dak hoa|xa dak hoa
dak hring|xa dak hring
dak jo ta|xa dak jo ta
dak kan|xa dak kan
dak ko ning|xa dak ko ning
dak koi|xa dak koi
dak krong|xa dak krong
dak kroong|xa dak kroong
dak lao|xa dak lao
dak la|xa dak la
dak lieng|xa dak lieng
dak long|xa dak long
dak lua|xa dak lua
dak mam|thi tran dak mam
dak mang|xa dak mang
dak man|xa dak man
dak mar|xa dak mar
dak mil|thi tran dak mil
dak mol|xa dak mol
dak mon|xa dak mon
dak n'drot|dak ndrot|xa dak n'drot|dak ndrot
dak n'dung|dak ndung|xa dak n'dung|dak ndung
dak nang|xa dak nang
dak na|xa dak na
dak nen|xa dak nen
dak ngok|xa dak ngok
dak ngo|xa dak ngo
dak nhau|xa dak nhau
dak nhoong|xa dak nhoong
dak nia|xa dak nia
dak nong|xa dak nong
dak nue|xa dak nue
dak o|xa dak o
dak pek|xa dak pek
dak phoi|xa dak phoi
dak plao|xa dak plao
dak pling|xa dak pling
dak pne|xa dak pne
dak po pho|xa dak po pho
dak po|thi tran dak po
dak pxi|xa dak pxi
dak r'la|dak rla|xa dak r'la|dak rla
dak r'mang|dak rmang|xa dak r'mang|dak rmang
dak r'moan|dak rmoan|xa dak r'moan|dak rmoan
dak r'tih|dak rtih|xa dak r'tih|dak rtih
dak ring|xa dak ring
dak ro nga|xa dak ro nga
dak ro ong|xa dak ro ong
dak ro wa|xa dak ro wa
dak roong|xa dak roong
dak ruong|xa dak ruong
dak ru|xa dak ru
dak rve|thi tran dak rve
dak sak|xa dak sak
dak sao|xa dak sao
dak sin|xa dak sin
dak smar|xa dak smar
dak somei|xa dak somei
dak som|xa dak som
dak song|xa dak song
dak sor|xa dak sor
dak ta ley|xa dak ta ley
dak tang|xa dak tang
dak to kan|xa dak to kan
dak to lung|xa dak to lung
dak to pang|xa dak to pang
dak to re|xa dak to re
dak to ver|xa dak to ver
dak to|thi tran dak to
dak tram|xa dak tram
dak troi|xa dak troi
dak ui|xa dak ui
dak wer|xa dak wer
dak wil|xa dak wil
dak xu|xa dak xu
dak ya|xa dak ya
dam bri|xa dam bri
dam doi|thi tran dam doi
dam ha|thi tran dam ha
dam ha|xa dam ha
dam thuy|xa dam thuy
dan chu|phuong dan chu
dan chu|xa dan chu
dan hoa|xa dan hoa
dan hoi|xa dan hoi
dan luc|xa dan luc
dan ly|xa dan ly
dan phuong|xa dan phuong
dan quyen|xa dan quyen
dan thang|xa dan thang
dan thanh|xa dan thanh
dan thuong|xa dan thuong
dan tien|xa dan tien
dan truong|xa dan truong
dan van|xa dan van
dang cuong|xa dang cuong
dang giang|phuong dang giang
dang hai|phuong dang hai
dang ha|xa dang ha
dang hung phuoc|xa dang hung phuoc
dang kang|xa dang kang
dang lam|phuong dang lam
dang le|xa dang le
dang son|xa dang son
dang xa|xa dang xa
danh thang|xa danh thang
dao duc|thi tran dao duc
dao duc|xa dao duc
dao duong|xa dao duong
dao huu canh|xa dao huu canh
dao long|phuong dao long
dao ly|xa dao ly
dao my|xa dao my
dao nghia|xa dao nghia
dao san|xa dao san
dao thanh|xa dao thanh
dao thinh|xa dao thinh
dao tru|xa dao tru
dao tu|xa dao tu
dao vien|xa dao vien
dao xa|xa dao xa
dap cau|phuong dap cau
dap da|phuong dap da
dap thanh|xa dap thanh
dat bang|xa dat bang
dat cuoc|xa dat cuoc
dat do|thi tran dat do
dat hieu|phuong dat hieu
dat moi|xa dat moi
dat mui|xa dat mui
dau giay|thi tran dau giay
dau lieu|phuong dau lieu
dau tieng|thi tran dau tieng
de ar|xa de ar
de su phinh|xa de su phinh
de tham|phuong de tham
de tham|xa de tham
den sang|xa den sang
den thang|xa den thang
deo gia|xa deo gia
di an|phuong di an
di che|xa di che
di lang|thi tran di lang
di linh|thi tran di linh
di nau|xa di nau
di su|phuong di su
di trach|xa di trach
dia linh|xa dia linh
dich qua|xa dich qua
dich vong hau|phuong dich vong hau
dich vong|phuong dich vong
diem dien|thi tran diem dien
diem he|xa diem he
diem hy|xa diem hy
diem mac|xa diem mac
diem thuy|xa diem thuy
dien an|phuong dien an
dien an|xa dien an
dien bich|xa dien bich
dien bien dong|thi tran dien bien dong
dien bien|phuong dien bien
dien binh|xa dien binh
dien cat|xa dien cat
dien chau|thi tran dien chau
dien dien|xa dien dien
dien doai|xa dien doai
dien dong|xa dien dong
dien duong|phuong dien duong
dien hai|xa dien hai
dien hanh|xa dien hanh
dien ha|xa dien ha
dien hoang|xa dien hoang
dien hoa|xa dien hoa
dien hong|phuong dien hong
dien hong|xa dien hong
dien hung|xa dien hung
dien huong|xa dien huong
dien khanh|thi tran dien khanh
dien kim|xa dien kim
dien ky|xa dien ky
dien lac|xa dien lac
dien lam|xa dien lam
dien lien|xa dien lien
dien loc|xa dien loc
dien loi|xa dien loi
dien lu|xa dien lu
dien minh|xa dien minh
dien mon|xa dien mon
dien my|xa dien my
dien nam bac|phuong dien nam bac
dien nam dong|phuong dien nam dong
dien nam trung|phuong dien nam trung
dien ngoc|phuong dien ngoc
dien ngoc|xa dien ngoc
dien nguyen|xa dien nguyen
dien phong|xa dien phong
dien phuc|xa dien phuc
dien phuoc|xa dien phuoc
dien phuong|xa dien phuong
dien phu|xa dien phu
dien quang|xa dien quang
dien quan|xa dien quan
dien sanh|thi tran dien sanh
dien son|xa dien son
dien tan|xa dien tan
dien thai|xa dien thai
dien thang bac|xa dien thang bac
dien thang nam|xa dien thang nam
dien thang trung|xa dien thang trung
dien thanh|xa dien thanh
dien thap|xa dien thap
dien thinh|xa dien thinh
dien tho|xa dien tho
dien thuong|xa dien thuong
dien tien|xa dien tien
dien toan|xa dien toan
dien trung|xa dien trung
dien truong|xa dien truong
dien van|xa dien van
dien xa|xa dien xa
dien xuan|xa dien xuan
dien yen|xa dien yen
diep nong|xa diep nong
dieu luong|xa dieu luong
dieu tri|thi tran dieu tri
din chin|xa din chin
dinh an|thi tran dinh an
dinh an|xa dinh an
dinh bang|phuong dinh bang
dinh ban|xa dinh ban
dinh bien|xa dinh bien
dinh binh|xa dinh binh
dinh cao|xa dinh cao
dinh ca|thi tran dinh ca
dinh chu|xa dinh chu
dinh cong|phuong dinh cong
dinh cong|xa dinh cong
dinh cu|xa dinh cu
dinh du|xa dinh du
dinh hai|xa dinh hai
dinh hiep|xa dinh hiep
dinh hoa|phuong dinh hoa
dinh hoa|xa dinh hoa
dinh hung|xa dinh hung
dinh ke|phuong dinh ke
dinh lac|xa dinh lac
dinh lap|thi tran dinh lap
dinh lap|xa dinh lap
dinh lien|xa dinh lien
dinh long|xa dinh long
dinh mon|xa dinh mon
dinh my|xa dinh my
dinh phong|xa dinh phong
dinh phung|xa dinh phung
dinh quan|thi tran dinh quan
dinh son|xa dinh son
dinh tang|xa dinh tang
dinh tan|xa dinh tan
dinh thanh a|xa dinh thanh a
dinh thanh|xa dinh thanh
dinh thuy|xa dinh thuy
dinh tien|xa dinh tien
dinh to|xa dinh to
dinh trang hoa|xa dinh trang hoa
dinh trang thuong|xa dinh trang thuong
dinh tri|xa dinh tri
dinh trung|xa dinh trung
dinh van|thi tran dinh van
dinh xa|xa dinh xa
dinh xuyen|xa dinh xuyen
dinh yen|xa dinh yen
dlie yang|xa dlie yang
dlie ya|xa dlie ya
do dong|xa do dong
do luong|thi tran do luong
do luong|xa do luong
do son|xa do son
do thanh|xa do thanh
do vinh|phuong do vinh
do xuyen|xa do xuyen
doai duong|xa doai duong
doan bai|xa doan bai
doan dao|xa doan dao
doan ha|xa doan ha
doan hung|thi tran doan hung
doan hung|xa doan hung
doan ket|phuong doan ket
doan ket|xa doan ket
doan lap|xa doan lap
doan thuong|xa doan thuong
doan tung|xa doan tung
doan xa|xa doan xa
doc binh kieu|xa doc binh kieu
doc lap|xa doc lap
doc tin|xa doc tin
doi 61|xa doi 61
doi binh|xa doi binh
doi can|phuong doi can
doi can|xa doi can
doi cung|phuong doi cung
doi ngo|thi tran doi ngo
dom cang|xa dom cang
don chau|xa don chau
don dac|xa don dac
don nhan|xa don nhan
don phong|xa don phong
don phuc|xa don phuc
don thuan|xa don thuan
don xa|xa don xa
don xuan|xa don xuan
dong anh|thi tran dong anh
dong an|xa dong an
dong a|xa dong a
dong bac|xa dong bac
dong bai|xa dong bai
dong bam|phuong dong bam
dong binh|xa dong binh
dong buc|xa dong buc
dong cac|xa dong cac
dong cam|xa dong cam
dong cao|xa dong cao
dong chum|xa dong chum
dong coc|xa dong coc
dong co|xa dong co
dong cuong|phuong dong cuong
dong cuong|xa dong cuong
dong cuu|xa dong cuu
dong dang|thi tran dong dang
dong dat|xa dong dat
dong da|phuong dong da
dong dong|xa dong dong
dong do|xa dong do
dong duong|xa dong duong
dong du|xa dong du
dong giang|phuong dong giang
dong giang|xa dong giang
dong giap|xa dong giap
dong hai 1|phuong dong hai 1
dong hai 2|phuong dong hai 2
dong hai|phuong dong hai
dong hai|xa dong hai
dong ha|xa dong ha
dong hiep|xa dong hiep
dong hieu|xa dong hieu
dong hoa hiep|xa dong hoa hiep
dong hoang|xa dong hoang
dong hoa|phuong dong hoa
dong hoa|xa dong hoa
dong hoi|xa dong hoi
dong hop|xa dong hop
dong ho|phuong dong ho
dong hung a|xa dong hung a
dong hung b|xa dong hung b
dong hung thuan|phuong dong hung thuan
dong hung|thi tran dong hung
dong hung|xa dong hung
dong huong|phuong dong huong
dong huong|xa dong huong
dong huu|xa dong huu
dong ich|xa dong ich
dong ket|xa dong ket
dong khe|phuong dong khe
dong khe|thi tran dong khe
dong khe|xa dong khe
dong khoi|xa dong khoi
dong kho|xa dong kho
dong kinh|phuong dong kinh
dong kinh|xa dong kinh
dong ky|phuong dong ky
dong ky|xa dong ky
dong lac|phuong dong lac
dong lac|xa dong lac
dong lai|xa dong lai
dong lam|xa dong lam
dong la|xa dong la
dong le|phuong dong le
dong le|thi tran dong le
dong lien|xa dong lien
dong linh|xa dong linh
dong loan|xa dong loan
dong loc|thi tran dong loc
dong loc|xa dong loc
dong loi|xa dong loi
dong long|xa dong long
dong lo|xa dong lo
dong luong|phuong dong luong
dong luong|xa dong luong
dong mac|phuong dong mac
dong mai|phuong dong mai
dong minh|xa dong minh
dong mon|xa dong mon
dong mo|thi tran dong mo
dong my|xa dong my
dong nai thuong|xa dong nai thuong
dong nai|xa dong nai
dong nam|xa dong nam
dong ngac|phuong dong ngac
dong ngan|phuong dong ngan
dong nguyen|phuong dong nguyen
dong ngu|xa dong ngu
dong nhan|phuong dong nhan
dong ninh|xa dong ninh
dong no|xa dong no
dong phong|phuong dong phong
dong phong|xa dong phong
dong phuc|xa dong phuc
dong phuoc a|xa dong phuoc a
dong phuoc|xa dong phuoc
dong phuong yen|xa dong phuong yen
dong phuong|xa dong phuong
dong phu|phuong dong phu
dong phu|thi tran dong phu
dong phu|xa dong phu
dong quang|phuong dong quang
dong quang|xa dong quang
dong quan|xa dong quan
dong que|xa dong que
dong qui|xa dong qui
dong quoc binh|phuong dong quoc binh
dong quy|xa dong quy
dong rui|xa dong rui
dong ruong|xa dong ruong
dong sang|xa dong sang
dong son|phuong dong son
dong son|xa dong son
dong tam|phuong dong tam
dong tam|thi tran dong tam
dong tam|xa dong tam
dong tan|xa dong tan
dong tao|xa dong tao
dong thai|xa dong thai
dong thang|xa dong thang
dong thanh|phuong dong thanh
dong thanh|thi tran dong thanh
dong thanh|xa dong thanh
dong than|xa dong than
dong thap|xa dong thap
dong thinh|xa dong thinh
dong thoi|xa dong thoi
dong tho|phuong dong tho
dong tho|xa dong tho
dong thuan|phuong dong thuan
dong thuan|xa dong thuan
dong tien|phuong dong tien
dong tien|xa dong tien
dong tinh|xa dong tinh
dong trach|xa dong trach
dong tra|xa dong tra
dong trieu|phuong dong trieu
dong truc|xa dong truc
dong trung|xa dong trung
dong tuyen|xa dong tuyen
dong van|phuong dong van
dong van|thi tran dong van
dong van|xa dong van
dong ve|phuong dong ve
dong viet|xa dong viet
dong vinh|phuong dong vinh
dong vinh|xa dong vinh
dong vuong|xa dong vuong
dong xa|xa dong xa
dong xuan|phuong dong xuan
dong xuan|xa dong xuan
dong xuyen|phuong dong xuyen
dong xuyen|xa dong xuyen
dong yen|xa dong yen
dong y|xa dong y
dooc may|xa dooc may
dray bhang|xa dray bhang
dray sap|xa dray sap
du gia|xa du gia
du hang kenh|phuong du hang kenh
du hang|phuong du hang
du le|xa du le
du sang|xa du sang
du tien|xa du tien
dua mon|xa dua mon
duc an|thi tran duc an
duc bac|xa duc bac
duc binh dong|xa duc binh dong
duc binh tay|xa duc binh tay
duc binh|xa duc binh
duc bong|xa duc bong
duc chanh|xa duc chanh
duc chinh|phuong duc chinh
duc chinh|xa duc chinh
duc dong|xa duc dong
duc giang|phuong duc giang
duc giang|xa duc giang
duc hanh|xa duc hanh
duc hiep|xa duc hiep
duc hoa dong|xa duc hoa dong
duc hoa ha|xa duc hoa ha
duc hoa thuong|xa duc hoa thuong
duc hoa|thi tran duc hoa
duc hoa|xa duc hoa
duc hong|xa duc hong
duc hop|xa duc hop
duc huong|xa duc huong
duc lang|xa duc lang
duc lan|xa duc lan
duc lap ha|xa duc lap ha
duc lap thuong|xa duc lap thuong
duc lien|xa duc lien
duc lieu|xa duc lieu
duc linh|xa duc linh
duc loi|xa duc loi
duc long|phuong duc long
duc long|xa duc long
duc luong|xa duc luong
duc ly|xa duc ly
duc manh|xa duc manh
duc minh|xa duc minh
duc my|xa duc my
duc nghia|phuong duc nghia
duc nhuan|xa duc nhuan
duc ninh dong|phuong duc ninh dong
duc ninh|xa duc ninh
duc phong|thi tran duc phong
duc phong|xa duc phong
duc pho|xa duc pho
duc phu|xa duc phu
duc quang|xa duc quang
duc son|xa duc son
duc tai|thi tran duc tai
duc tan|xa duc tan
duc thang|phuong duc thang
duc thang|xa duc thang
duc thanh|xa duc thanh
duc thong|xa duc thong
duc tho|thi tran duc tho
duc thuan|phuong duc thuan
duc thuan|xa duc thuan
duc thuong|xa duc thuong
duc tin|xa duc tin
duc trach|xa duc trach
duc tu|xa duc tu
duc van|xa duc van
duc xuan|phuong duc xuan
duc xuan|xa duc xuan
duc xuong|xa duc xuong
duc xuyen|xa duc xuyen
duc yen|xa duc yen
dung kno|xa dung kno
dung liet|xa dung liet
dung nghia|xa dung nghia
dung phong|xa dung phong
dung tien|xa dung tien
duong 10|xa duong 10
duong am|xa duong am
duong diem|xa duong diem
duong dong|thi tran duong dong
duong duc|xa duong duc
duong ha|xa duong ha
duong hoa|xa duong hoa
duong hong thuy|xa duong hong thuy
duong hong|xa duong hong
duong huu|xa duong huu
duong huy|xa duong huy
duong lam|xa duong lam
duong lieu|xa duong lieu
duong minh chau|thi tran duong minh chau
duong noi|phuong duong noi
duong phong|xa duong phong
duong phuc|xa duong phuc
duong quang|xa duong quang
duong quan|xa duong quan
duong quy|xa duong quy
duong son|xa duong son
duong thanh|xa duong thanh
duong thuong|xa duong thuong
duong thuy|xa duong thuy
duong to|xa duong to
duong xa|xa duong xa
duong xuan hoi|xa duong xuan hoi
dur kmal|xa dur kmal
duu lau|phuong duu lau
duy chau|xa duy chau
duy hai|phuong duy hai
duy hai|xa duy hai
duy hoa|xa duy hoa
duy minh|phuong duy minh
duy nghia|xa duy nghia
duy nhat|xa duy nhat
duy ninh|xa duy ninh
duy phien|xa duy phien
duy phuoc|xa duy phuoc
duy phu|xa duy phu
duy son|xa duy son
duy tan|phuong duy tan
duy tan|xa duy tan
duy thanh|xa duy thanh
duy thu|xa duy thu
duy trinh|xa duy trinh
duy trung|xa duy trung
duy vinh|xa duy vinh
duyen hai|phuong duyen hai
duyen hai|xa duyen hai
duyen ha|xa duyen ha
duyen thai|xa duyen thai
duyet trung|phuong duyet trung
e tong|xa e tong
ea bar|xa ea bar
ea ba|xa ea ba
ea bhok|xa ea bhok
ea blang|xa ea blang
ea bong|xa ea bong
ea bung|xa ea bung
ea d'rong|ea drong|xa ea d'rong|ea drong
ea dah|xa ea dah
ea dar|xa ea dar
ea drang|thi tran ea drang
ea drong|xa ea drong
ea h'dinh|ea hdinh|xa ea h'dinh|ea hdinh
ea h'leo|ea hleo|xa ea h'leo|ea hleo
ea h'mlay|ea hmlay|xa ea h'mlay|ea hmlay
ea hiao|xa ea hiao
ea hiu|xa ea hiu
ea ho|xa ea ho
ea huar|xa ea huar
ea hu|xa ea hu
ea kao|xa ea kao
ea kar|thi tran ea kar
ea kenh|xa ea kenh
ea khal|xa ea khal
ea kiet|xa ea kiet
ea kly|xa ea kly
ea kmut|xa ea kmut
ea knop|thi tran ea knop
ea knuec|xa ea knuec
ea kpam|xa ea kpam
ea ktur|xa ea ktur
ea kuang|xa ea kuang
ea kueh|xa ea kueh
ea lai|xa ea lai
ea lam|xa ea lam
ea le|xa ea le
ea m'doal|ea mdoal|xa ea m'doal|ea mdoal
ea m'droh|ea mdroh|xa ea m'droh|ea mdroh
ea m'nang|ea mnang|xa ea m'nang|ea mnang
ea nam|xa ea nam
ea na|xa ea na
ea ngai|xa ea ngai
ea ning|xa ea ning
ea nuol|xa ea nuol
ea o|xa ea o
ea pal|xa ea pal
ea phe|xa ea phe
ea pil|xa ea pil
ea pok|thi tran ea pok
ea po|xa ea po
ea puk|xa ea puk
ea r'bin|ea rbin|xa ea r'bin|ea rbin
ea ral|xa ea ral
ea rieng|xa ea rieng
ea rok|xa ea rok
ea sar|xa ea sar
ea sien|xa ea sien
ea sin|xa ea sin
ea sol|xa ea sol
ea so|xa ea so
ea sup|thi tran ea sup
ea t'ling|ea tling|thi tran ea t'ling|ea tling
ea tam|phuong ea tam
ea tam|xa ea tam
ea tan|xa ea tan
ea tar|xa ea tar
ea tieu|xa ea tieu
ea tih|xa ea tih
ea tir|xa ea tir
ea toh|xa ea toh
ea trang|xa ea trang
ea trul|xa ea trul
ea tul|xa ea tul
ea tu|xa ea tu
ea uy|xa ea uy
ea wer|xa ea wer
ea wy|xa ea wy
ea yieng|xa ea yieng
ea yong|xa ea yong
eacha rang|xa eacha rang
ga ri|xa ga ri
ganh dau|xa ganh dau
ganh hao|thi tran ganh hao
gao giong|xa gao giong
ghenh rang|phuong ghenh rang
gia an|xa gia an
gia bac|xa gia bac
gia binh|phuong gia binh
gia binh|thi tran gia binh
gia cam|phuong gia cam
gia canh|xa gia canh
gia cat|xa gia cat
gia dien|xa gia dien
gia dong|xa gia dong
gia duc|xa gia duc
gia hanh|xa gia hanh
gia hiep|xa gia hiep
gia hoa 1|xa gia hoa 1
gia hoa 2|xa gia hoa 2
gia hoa|xa gia hoa
gia hoi|xa gia hoi
gia hung|xa gia hung
gia huynh|xa gia huynh
gia khanh|thi tran gia khanh
gia khanh|xa gia khanh
gia kiem|xa gia kiem
gia lac|xa gia lac
gia lam|xa gia lam
gia lap|xa gia lap
gia loc|phuong gia loc
gia loc|thi tran gia loc
gia loc|xa gia loc
gia luan|xa gia luan
gia luong|xa gia luong
gia mien|xa gia mien
gia minh|xa gia minh
gia mo|xa gia mo
gia ninh|xa gia ninh
gia phong|xa gia phong
gia pho|xa gia pho
gia phuong|xa gia phuong
gia phu|xa gia phu
gia ray|thi tran gia ray
gia sang|phuong gia sang
gia sinh|xa gia sinh
gia son|xa gia son
gia tan 1|xa gia tan 1
gia tan 2|xa gia tan 2
gia tan 3|xa gia tan 3
gia tan|xa gia tan
gia thang|xa gia thang
gia thanh|xa gia thanh
gia thinh|xa gia thinh
gia thuan|xa gia thuan
gia thuy|phuong gia thuy
gia thuy|xa gia thuy
gia tien|xa gia tien
gia tran|xa gia tran
gia trung|xa gia trung
gia tuong|xa gia tuong
gia van|xa gia van
gia vien|phuong gia vien
gia vien|xa gia vien
gia vuong|xa gia vuong
gia xuan|xa gia xuan
gia xuyen|xa gia xuyen
giai pham|xa giai pham
giai xuan|xa giai xuan
giang bien|phuong giang bien
giang bien|xa giang bien
giang chu phin|xa giang chu phin
giang dien|xa giang dien
giang hai|xa giang hai
giang ly|xa giang ly
giang ma|xa giang ma
giang son dong|xa giang son dong
giang son tay|xa giang son tay
giang son|xa giang son
giang tien|thi tran giang tien
giang vo|phuong giang vo
giao an|xa giao an
giao chau|xa giao chau
giao hai|xa giao hai
giao ha|xa giao ha
giao hieu|xa giao hieu
giao huong|xa giao huong
giao lac|xa giao lac
giao liem|xa giao liem
giao long|xa giao long
giao nhan|xa giao nhan
giao phong|xa giao phong
giao tan|xa giao tan
giao thanh|xa giao thanh
giao thien|xa giao thien
giao thinh|xa giao thinh
giao tien|xa giao tien
giao xuan|xa giao xuan
giao yen|xa giao yen
giap bat|phuong giap bat
giap dat|xa giap dat
giap lai|xa giap lai
giap son|xa giap son
giap trung|xa giap trung
gieng day|phuong gieng day
gio an|xa gio an
gio chau|xa gio chau
gio hai|xa gio hai
gio linh|thi tran gio linh
gio mai|xa gio mai
gio my|xa gio my
gio quang|xa gio quang
gio son|xa gio son
gio viet|xa gio viet
gioi phien|xa gioi phien
giong rieng|thi tran giong rieng
giong trom|thi tran giong trom
giuc tuong|xa giuc tuong
go dau|thi tran go dau
go quao|thi tran go quao
gung re|xa gung re
h bong|xa h bong
ha an|phuong ha an
ha bac|xa ha bac
ha bang|xa ha bang
ha bau|xa ha bau
ha binh|xa ha binh
ha cau|phuong ha cau
ha chau|xa ha chau
ha dinh|phuong ha dinh
ha dong|xa ha dong
ha giang|xa ha giang
ha giap|xa ha giap
ha hai|xa ha hai
ha hieu|xa ha hieu
ha hoa|thi tran ha hoa
ha hoi|xa ha hoi
ha huy tap|phuong ha huy tap
ha khanh|phuong ha khanh
ha khau|phuong ha khau
ha ky|xa ha ky
ha lai|xa ha lai
ha lam|phuong ha lam
ha lam|thi tran ha lam
ha lam|xa ha lam
ha lang|xa ha lang
ha lau|xa ha lau
ha le|xa ha le
ha linh|xa ha linh
ha loc|xa ha loc
ha long|phuong ha long
ha long|xa ha long
ha luong|xa ha luong
ha ly|phuong ha ly
ha man|xa ha man
ha mon|xa ha mon
ha mo|xa ha mo
ha ngoc|xa ha ngoc
ha phong|phuong ha phong
ha son|xa ha son
ha tam|xa ha tam
ha tan|xa ha tan
ha tay|xa ha tay
ha thach|xa ha thach
ha thai|xa ha thai
ha thanh|xa ha thanh
ha thuong|xa ha thuong
ha tien|xa ha tien
ha trach|xa ha trach
ha trung|phuong ha trung
ha trung|thi tran ha trung
ha trung|xa ha trung
ha tu|phuong ha tu
ha vinh|xa ha vinh
hac dich|phuong hac dich
hai anh|xa hai anh
hai an|phuong hai an
hai an|xa hai an
hai ba trung|phuong hai ba trung
hai bac|xa hai bac
hai ba|xa hai ba
hai binh|phuong hai binh
hai boi|xa hai boi
hai cang|phuong hai cang
hai chanh|xa hai chanh
hai chau ii|phuong hai chau ii
hai chau i|phuong hai chau i
hai chau|phuong hai chau
hai chau|xa hai chau
hai chinh|xa hai chinh
hai cuong|xa hai cuong
hai dinh|xa hai dinh
hai dong|xa hai dong
hai duong|xa hai duong
hai giang|xa hai giang
hai ha|xa hai ha
hai hoa|phuong hai hoa
hai hoa|xa hai hoa
hai hung|xa hai hung
hai khe|xa hai khe
hai lam|xa hai lam
hai lang|xa hai lang
hai le|xa hai le
hai linh|phuong hai linh
hai loc|xa hai loc
hai long|xa hai long
hai luu|xa hai luu
hai ly|xa hai ly
hai minh|xa hai minh
hai nam|xa hai nam
hai nhan|xa hai nhan
hai ninh|phuong hai ninh
hai ninh|xa hai ninh
hai phong|xa hai phong
hai phuc|xa hai phuc
hai phuong|xa hai phuong
hai phu|xa hai phu
hai quang|xa hai quang
hai que|xa hai que
hai quy|xa hai quy
hai rieng|thi tran hai rieng
hai son|phuong hai son
hai son|xa hai son
hai tan|phuong hai tan
hai tan|xa hai tan
hai tay|xa hai tay
hai thai|xa hai thai
hai thanh|phuong hai thanh
hai thanh|xa hai thanh
hai thuong|phuong hai thuong
hai thuong|xa hai thuong
hai tien|xa hai tien
hai trieu|xa hai trieu
hai trung|xa hai trung
hai truong|xa hai truong
hai van|xa hai van
hai xuan|xa hai xuan
hai yang|xa hai yang
hai yen|phuong hai yen
hai yen|xa hai yen
ham can|xa ham can
ham chinh|xa ham chinh
ham cuong|xa ham cuong
ham duc|xa ham duc
ham giang|xa ham giang
ham hiep|xa ham hiep
ham kiem|xa ham kiem
ham liem|xa ham liem
ham minh|xa ham minh
ham my|xa ham my
ham ninh|xa ham ninh
ham phu|xa ham phu
ham rong|phuong ham rong
ham rong|xa ham rong
ham tan|xa ham tan
ham thang|xa ham thang
ham thanh|xa ham thanh
ham tien|phuong ham tien
ham tri|xa ham tri
ham tu|xa ham tu
han da|xa han da
han quang|xa han quang
hang bac|phuong hang bac
hang bai|phuong hang bai
hang bong|phuong hang bong
hang bot|phuong hang bot
hang bo|phuong hang bo
hang buom|phuong hang buom
hang chu|xa hang chu
hang dao|phuong hang dao
hang dong|xa hang dong
hang gai|phuong hang gai
hang gon|xa hang gon
hang kenh|phuong hang kenh
hang kia|xa hang kia
hang lia|xa hang lia
hang ma|phuong hang ma
hang tram|thi tran hang tram
hang trong|phuong hang trong
hang vinh|xa hang vinh
hanh cu|xa hanh cu
hanh dich|xa hanh dich
hanh duc|xa hanh duc
hanh dung|xa hanh dung
hanh lam|xa hanh lam
hanh minh|xa hanh minh
hanh nhan|xa hanh nhan
hanh phuc|xa hanh phuc
hanh phuoc|xa hanh phuoc
hanh son|xa hanh son
hanh thien|xa hanh thien
hanh thinh|xa hanh thinh
hanh thuan|xa hanh thuan
hanh tin dong|xa hanh tin dong
hanh tin tay|xa hanh tin tay
hanh trung|xa hanh trung
hao duoc|xa hao duoc
hao phu|xa hao phu
hap linh|phuong hap linh
hat liu|xa hat liu
hat lot|thi tran hat lot
hat lot|xa hat lot
hat mon|xa hat mon
hau loc|thi tran hau loc
hau loc|xa hau loc
hau my bac a|xa hau my bac a
hau my bac b|xa hau my bac b
hau my phu|xa hau my phu
hau my trinh|xa hau my trinh
hau nghia|thi tran hau nghia
hau thanh dong|xa hau thanh dong
hau thanh tay|xa hau thanh tay
hau thanh|xa hau thanh
he muong|xa he muong
hien chung|xa hien chung
hien giang|xa hien giang
hien hao|xa hien hao
hien khanh|xa hien khanh
hien kiet|xa hien kiet
hien luong|xa hien luong
hien nam|phuong hien nam
hien ninh|xa hien ninh
hien quan|xa hien quan
hien son|xa hien son
hien thanh|phuong hien thanh
hien thanh|xa hien thanh
hien van|xa hien van
hiep an|phuong hiep an
hiep an|xa hiep an
hiep binh chanh|phuong hiep binh chanh
hiep binh phuoc|phuong hiep binh phuoc
hiep cat|xa hiep cat
hiep cuong|xa hiep cuong
hiep duc|xa hiep duc
hiep hoa|phuong hiep hoa
hiep hoa|thi tran hiep hoa
hiep hoa|xa hiep hoa
hiep hung|xa hiep hung
hiep loi|phuong hiep loi
hiep luc|xa hiep luc
hiep my dong|xa hiep my dong
hiep my tay|xa hiep my tay
hiep ninh|phuong hiep ninh
hiep phuoc|thi tran hiep phuoc
hiep phuoc|xa hiep phuoc
hiep phu|phuong hiep phu
hiep son|phuong hiep son
hiep tan|phuong hiep tan
hiep thanh|phuong hiep thanh
hiep thanh|xa hiep thanh
hiep thuan|xa hiep thuan
hiep tung|xa hiep tung
hiep xuong|xa hiep xuong
hieu liem|xa hieu liem
hieu nghia|xa hieu nghia
hieu nhon|xa hieu nhon
hieu phung|xa hieu phung
hieu thanh|xa hieu thanh
hieu thuan|xa hieu thuan
hieu trung|xa hieu trung
hieu tu|xa hieu tu
him lam|phuong him lam
ho bon|xa ho bon
ho dac kien|xa ho dac kien
ho dap|xa ho dap
ho do|xa ho do
ho hai|xa ho hai
ho mit|xa ho mit
ho moong|xa ho moong
ho nai 3|xa ho nai 3
ho nai|phuong ho nai
ho nam|phuong ho nam
ho phong|phuong ho phong
ho quang phin|xa ho quang phin
ho son|xa ho son
ho thau|xa ho thau
ho thi ky|xa ho thi ky
ho tung mau|xa ho tung mau
ho xa|thi tran ho xa
hoa an|phuong hoa an
hoa an|xa hoa an
hoa bac|xa hoa bac
hoa binh 1|xa hoa binh 1
hoa binh thanh|xa hoa binh thanh
hoa binh|phuong hoa binh
hoa binh|thi tran hoa binh
hoa binh|xa hoa binh
hoa chanh|xa hoa chanh
hoa chau|xa hoa chau
hoa chinh|xa hoa chinh
hoa chung|phuong hoa chung
hoa cuong bac|phuong hoa cuong bac
hoa cuong nam|phuong hoa cuong nam
hoa cuong|xa hoa cuong
hoa cu|xa hoa cu
hoa dien|xa hoa dien
hoa dinh dong|xa hoa dinh dong
hoa dinh tay|xa hoa dinh tay
hoa dinh|xa hoa dinh
hoa dong|xa hoa dong
hoa hai|phuong hoa hai
hoa hai|xa hoa hai
hoa hau|xa hoa hau
hoa hiep bac|phuong hoa hiep bac
hoa hiep nam|phuong hoa hiep nam
hoa hiep trung|phuong hoa hiep trung
hoa hiep|xa hoa hiep
hoa hieu|phuong hoa hieu
hoa hoi|xa hoa hoi
hoa hop|xa hoa hop
hoa hung|xa hoa hung
hoa huong|phuong hoa huong
hoa khanh bac|phuong hoa khanh bac
hoa khanh dong|xa hoa khanh dong
hoa khanh nam|phuong hoa khanh nam
hoa khanh nam|xa hoa khanh nam
hoa khanh tay|xa hoa khanh tay
hoa khanh|xa hoa khanh
hoa khe|phuong hoa khe
hoa khuong|xa hoa khuong
hoa kien|xa hoa kien
hoa lac|phuong hoa lac
hoa lac|xa hoa lac
hoa lam|xa hoa lam
hoa le|xa hoa le
hoa lien|xa hoa lien
hoa loc|xa hoa loc
hoa loi|phuong hoa loi
hoa loi|xa hoa loi
hoa long|phuong hoa long
hoa long|xa hoa long
hoa luu|xa hoa luu
hoa lu|phuong hoa lu
hoa mac|phuong hoa mac
hoa mac|xa hoa mac
hoa minh|phuong hoa minh
hoa minh|xa hoa minh
hoa muc|xa hoa muc
hoa my dong|xa hoa my dong
hoa my tay|xa hoa my tay
hoa my|xa hoa my
hoa nam|xa hoa nam
hoa nghia|phuong hoa nghia
hoa nghia|xa hoa nghia
hoa nhon|xa hoa nhon
hoa ninh|xa hoa ninh
hoa phat|phuong hoa phat
hoa phong|xa hoa phong
hoa phuc|xa hoa phuc
hoa phuoc|xa hoa phuoc
hoa phu|phuong hoa phu
hoa phu|xa hoa phu
hoa quang bac|xa hoa quang bac
hoa quang nam|xa hoa quang nam
hoa quy|phuong hoa quy
hoa quy|xa hoa quy
hoa son|thi tran hoa son
hoa son|xa hoa son
hoa tam|xa hoa tam
hoa tan dong|xa hoa tan dong
hoa tan tay|xa hoa tan tay
hoa tan|xa hoa tan
hoa thach|xa hoa thach
hoa tham|xa hoa tham
hoa thang|xa hoa thang
hoa thanh|phuong hoa thanh
hoa thanh|xa hoa thanh
hoa thinh|xa hoa thinh
hoa tho dong|phuong hoa tho dong
hoa tho tay|phuong hoa tho tay
hoa thuan dong|phuong hoa thuan dong
hoa thuan tay|phuong hoa thuan tay
hoa thuan|phuong hoa thuan
hoa thuan|thi tran hoa thuan
hoa thuan|xa hoa thuan
hoa thuong|xa hoa thuong
hoa thuy|xa hoa thuy
hoa tien|xa hoa tien
hoa tinh|xa hoa tinh
hoa trach|xa hoa trach
hoa tri|xa hoa tri
hoa trung|xa hoa trung
hoa tu 1|xa hoa tu 1
hoa tu ii|xa hoa tu ii
hoa vinh|phuong hoa vinh
hoa xa|xa hoa xa
hoa xuan dong|xa hoa xuan dong
hoa xuan nam|xa hoa xuan nam
hoa xuan tay|phuong hoa xuan tay
hoa xuan|phuong hoa xuan
hoa xuan|xa hoa xuan
hoai chau bac|xa hoai chau bac
hoai chau|xa hoai chau
hoai duc|phuong hoai duc
hoai duc|xa hoai duc
hoai hai|xa hoai hai
hoai hao|phuong hoai hao
hoai huong|phuong hoai huong
hoai my|xa hoai my
hoai phu|xa hoai phu
hoai son|xa hoai son
hoai tan|phuong hoai tan
hoai thanh tay|phuong hoai thanh tay
hoai thanh|phuong hoai thanh
hoai thuong|xa hoai thuong
hoai xuan|phuong hoai xuan
hoan lao|thi tran hoan lao
hoan long|xa hoan long
hoan son|xa hoan son
hoang an|xa hoang an
hoang cat|xa hoang cat
hoang chau|xa hoang chau
hoang cuong|xa hoang cuong
hoang dai|xa hoang dai
hoang dan|xa hoang dan
hoang dao|xa hoang dao
hoang dat|xa hoang dat
hoang dieu|phuong hoang dieu
hoang dieu|xa hoang dieu
hoang dong|phuong hoang dong
hoang dong|xa hoang dong
hoang duc|xa hoang duc
hoang giang|xa hoang giang
hoang hai|xa hoang hai
hoang hanh|xa hoang hanh
hoang ha|xa hoang ha
hoang hoa tham|xa hoang hoa tham
hoang hoa|xa hoang hoa
hoang hop|xa hoang hop
hoang khai|xa hoang khai
hoang kim|xa hoang kim
hoang lau|xa hoang lau
hoang lien|xa hoang lien
hoang liet|phuong hoang liet
hoang loc|xa hoang loc
hoang long|xa hoang long
hoang luong|xa hoang luong
hoang luu|xa hoang luu
hoang nam|xa hoang nam
hoang ngoc|xa hoang ngoc
hoang nong|xa hoang nong
hoang phong|xa hoang phong
hoang phuong|xa hoang phuong
hoang phu|xa hoang phu
hoang quang|xa hoang quang
hoang que|phuong hoang que
hoang quy|xa hoang quy
hoang son|xa hoang son
hoang tan|phuong hoang tan
hoang tan|xa hoang tan
hoang tay|xa hoang tay
hoang thai|xa hoang thai
hoang thang|xa hoang thang
hoang thanh|xa hoang thanh
hoang then|xa hoang then
hoang thinh|xa hoang thinh
hoang thu pho|xa hoang thu pho
hoang tien|phuong hoang tien
hoang tien|xa hoang tien
hoang trach|xa hoang trach
hoang trinh|xa hoang trinh
hoang tri|xa hoang tri
hoang trung|xa hoang trung
hoang truong|xa hoang truong
hoang tung|xa hoang tung
hoang van thu|phuong hoang van thu
hoang van thu|xa hoang van thu
hoang van|xa hoang van
hoang viet|xa hoang viet
hoang xa|xa hoang xa
hoang xuan|xa hoang xuan
hoang xuyen|xa hoang xuyen
hoang yen|xa hoang yen
hoanh bo|phuong hoanh bo
hoanh mo|xa hoanh mo
hoanh son|xa hoanh son
hoat giang|xa hoat giang
hoc mon|thi tran hoc mon
hoi an dong|xa hoi an dong
hoi an|xa hoi an
hoi hoan|xa hoi hoan
hoi hop|phuong hoi hop
hoi nghia|phuong hoi nghia
hoi ninh|xa hoi ninh
hoi phu|phuong hoi phu
hoi son|xa hoi son
hoi thuong|phuong hoi thuong
hoi xuan|thi tran hoi xuan
hoi xuan|xa hoi xuan
hon dat|thi tran hon dat
hon nghe|xa hon nghe
hon thom|xa hon thom
hon tre|xa hon tre
hong an|xa hong an
hong bach|xa hong bach
hong bac|xa hong bac
hong ca|xa hong ca
hong chau|phuong hong chau
hong chau|xa hong chau
hong duc|xa hong duc
hong dung|xa hong dung
hong duong|xa hong duong
hong du|xa hong du
hong gai|phuong hong gai
hong giang|xa hong giang
hong hai|phuong hong hai
hong ha|phuong hong ha
hong ha|xa hong ha
hong hoa|xa hong hoa
hong hung|xa hong hung
hong khe|xa hong khe
hong kim|xa hong kim
hong ky|xa hong ky
hong lac|xa hong lac
hong liem|xa hong liem
hong linh|xa hong linh
hong loc|xa hong loc
hong long|xa hong long
hong ly|xa hong ly
hong minh|xa hong minh
hong nam|xa hong nam
hong ngai|xa hong ngai
hong phong|phuong hong phong
hong phong|xa hong phong
hong phuc|xa hong phuc
hong phuong|xa hong phuong
hong quang|xa hong quang
hong son|phuong hong son
hong son|xa hong son
hong sy|xa hong sy
hong thai dong|xa hong thai dong
hong thai tay|xa hong thai tay
hong thai|xa hong thai
hong thanh|xa hong thanh
hong thuan|xa hong thuan
hong thuong|xa hong thuong
hong thuy|xa hong thuy
hong thu|xa hong thu
hong tien|xa hong tien
hong tri|xa hong tri
hong van|xa hong van
hong viet|xa hong viet
hop chau|thi tran hop chau
hop dong|xa hop dong
hop duc|phuong hop duc
hop duc|xa hop duc
hop giang|phuong hop giang
hop hoa|thi tran hop hoa
hop hoa|xa hop hoa
hop hung|xa hop hung
hop ly|xa hop ly
hop minh|phuong hop minh
hop nhat|xa hop nhat
hop phong|xa hop phong
hop thang|xa hop thang
hop thanh|xa hop thanh
hop thinh|xa hop thinh
hop tien|xa hop tien
hua bun|xa hua bun
hua la|xa hua la
hua na|xa hua na
hua ngai|xa hua ngai
hua nhan|xa hua nhan
hua pang|xa hua pang
hua thanh|xa hua thanh
hua trai|xa hua trai
huc dong|xa huc dong
huc nghi|xa huc nghi
hung an|xa hung an
hung binh|phuong hung binh
hung binh|xa hung binh
hung chien|phuong hung chien
hung chinh|xa hung chinh
hung cong|xa hung cong
hung cuong|xa hung cuong
hung dao|phuong hung dao
hung dao|xa hung dao
hung dien a|xa hung dien a
hung dien b|xa hung dien b
hung dien|xa hung dien
hung dinh|phuong hung dinh
hung dong|xa hung dong
hung duc|xa hung duc
hung dung|phuong hung dung
hung dung|xa hung dung
hung ha|thi tran hung ha
hung ha|xa hung ha
hung hoa|thi tran hung hoa
hung hoa|xa hung hoa
hung hoi|xa hung hoi
hung khanh trung a|xa hung khanh trung a
hung khanh trung b|xa hung khanh trung b
hung khanh|xa hung khanh
hung le|xa hung le
hung linh|xa hung linh
hung loc|xa hung loc
hung loi|phuong hung loi
hung loi|thi tran hung loi
hung loi|xa hung loi
hung long|phuong hung long
hung long|xa hung long
hung lo|xa hung lo
hung my|xa hung my
hung nghia|xa hung nghia
hung nguyen|thi tran hung nguyen
hung nhan|thi tran hung nhan
hung nhan|xa hung nhan
hung nhuong|xa hung nhuong
hung phong|xa hung phong
hung phuc|phuong hung phuc
hung phuc|xa hung phuc
hung phuoc|xa hung phuoc
hung phu|phuong hung phu
hung phu|xa hung phu
hung son|thi tran hung son
hung son|xa hung son
hung tan|xa hung tan
hung tay|xa hung tay
hung thang|phuong hung thang
hung thang|xa hung thang
hung thanh|phuong hung thanh
hung thanh|xa hung thanh
hung thinh|xa hung thinh
hung thi|xa hung thi
hung thong|xa hung thong
hung thuan|xa hung thuan
hung thuy|xa hung thuy
hung tien|xa hung tien
hung trach|xa hung trach
hung tri|phuong hung tri
hung trung|xa hung trung
hung viet|xa hung viet
hung vuong|phuong hung vuong
hung vu|xa hung vu
hung xuyen|xa hung xuyen
hung yen bac|xa hung yen bac
hung yen|xa hung yen
huoi leng|xa huoi leng
huoi lenh|xa huoi lenh
huoi luong|xa huoi luong
huoi mi|xa huoi mi
huoi mot|xa huoi mot
huoi so|xa huoi so
huoi tu|xa huoi tu
huong an|phuong huong an
huong an|thi tran huong an
huong binh|xa huong binh
huong canh|thi tran huong canh
huong can|xa huong can
huong chu|phuong huong chu
huong dao|xa huong dao
huong do|xa huong do
huong giang|xa huong giang
huong gian|xa huong gian
huong hiep|xa huong hiep
huong hoa|xa huong hoa
huong ho|phuong huong ho
huong huu|xa huong huu
huong khe|thi tran huong khe
huong lac|xa huong lac
huong lam|xa huong lam
huong lap|xa huong lap
huong lien|xa huong lien
huong linh|xa huong linh
huong loc|xa huong loc
huong long|phuong huong long
huong long|xa huong long
huong lung|xa huong lung
huong mac|xa huong mac
huong mai|xa huong mai
huong minh|xa huong minh
huong my|xa huong my
huong ngai|xa huong ngai
huong nguyen|xa huong nguyen
huong nhuong|xa huong nhuong
huong non|xa huong non
huong phong|xa huong phong
huong phung|xa huong phung
huong phu|xa huong phu
huong son|phuong huong son
huong son|thi tran huong son
huong son|xa huong son
huong so|phuong huong so
huong tan|xa huong tan
huong tho phu|xa huong tho phu
huong tho|xa huong tho
huong thuong|xa huong thuong
huong thuy|xa huong thuy
huong toan|xa huong toan
huong trach|xa huong trach
huong tra|xa huong tra
huong van|phuong huong van
huong viet|xa huong viet
huong vinh|xa huong vinh
huong vi|xa huong vi
huong xa|xa huong xa
huong xuan|phuong huong xuan
huong xuan|xa huong xuan
huu bang|xa huu bang
huu dao|xa huu dao
huu dinh|xa huu dinh
huu hoa|xa huu hoa
huu khanh|xa huu khanh
huu khuong|xa huu khuong
huu kiem|xa huu kiem
huu kien|xa huu kien
huu lan|xa huu lan
huu lap|xa huu lap
huu le|xa huu le
huu lien|xa huu lien
huu loi|xa huu loi
huu lung|thi tran huu lung
huu nghi|phuong huu nghi
huu san|xa huu san
huu thanh|xa huu thanh
huu van|xa huu van
huu vinh|xa huu vinh
huy bac|xa huy bac
huy giap|xa huy giap
huy ha|xa huy ha
huy khiem|xa huy khiem
huy tan|xa huy tan
huy thuong|xa huy thuong
huy tuong|xa huy tuong
huyen hoi|xa huyen hoi
huyen son|xa huyen son
huyen tung|phuong huyen tung
huynh huu nghia|thi tran huynh huu nghia
hy cuong|xa hy cuong
ia ake|xa ia ake
ia bang|xa ia bang
ia ba|xa ia ba
ia blang|xa ia blang
ia blu|xa ia blu
ia boong|xa ia boong
ia broai|xa ia broai
ia chia|xa ia chia
ia chim|xa ia chim
ia dal|xa ia dal
ia der|xa ia der
ia din|xa ia din
ia dok|xa ia dok
ia dom|xa ia dom
ia drang|xa ia drang
ia dreng|xa ia dreng
ia ga|xa ia ga
ia glai|xa ia glai
ia grang|xa ia grang
ia hdreh|xa ia hdreh
ia hiao|xa ia hiao
ia hla|xa ia hla
ia hlop|xa ia hlop
ia hrung|xa ia hrung
ia hru|xa ia hru
ia jloi|xa ia jloi
ia ka|xa ia ka
ia kdam|xa ia kdam
ia kenh|xa ia kenh
ia khai|xa ia khai
ia kha|thi tran ia kha
ia khuol|xa ia khuol
ia kla|xa ia kla
ia kly|xa ia kly
ia ko|xa ia ko
ia krai|xa ia krai
ia krel|xa ia krel
ia kreng|xa ia kreng
ia krieng|xa ia krieng
ia kring|phuong ia kring
ia lang|xa ia lang
ia lau|xa ia lau
ia le|xa ia le
ia lop|xa ia lop
ia ly|thi tran ia ly
ia ma ron|xa ia ma ron
ia me|xa ia me
ia mlah|xa ia mlah
ia mo nong|xa ia mo nong
ia mo|xa ia mo
ia nan|xa ia nan
ia nhin|xa ia nhin
ia o|xa ia o
ia pal|xa ia pal
ia pech|xa ia pech
ia peng|xa ia peng
ia pet|xa ia pet
ia phang|xa ia phang
ia phin|xa ia phin
ia phi|xa ia phi
ia piar|xa ia piar
ia pia|xa ia pia
ia pior|xa ia pior
ia pnon|xa ia pnon
ia puch|xa ia puch
ia rbol|xa ia rbol
ia rmok|xa ia rmok
ia rong|xa ia rong
ia rsai|xa ia rsai
ia rsuom|xa ia rsuom
ia rto|xa ia rto
ia rve|xa ia rve
ia sao|xa ia sao
ia sol|xa ia sol
ia tiem|xa ia tiem
ia toi|xa ia toi
ia tor|xa ia tor
ia to|xa ia to
ia trok|xa ia trok
ia tul|xa ia tul
ia ve|xa ia ve
ia yeng|xa ia yeng
ia yok|xa ia yok
ich hau|xa ich hau
it ong|thi tran it ong
jo ngay|xa jo ngay
ka dang|xa ka dang
ka don|xa ka don
ka do|xa ka do
ka lang|xa ka lang
ka long|phuong ka long
kan ho|xa kan ho
ke an|xa ke an
ke sach|thi tran ke sach
ke sat|thi tran ke sat
ke thanh|xa ke thanh
keng du|xa keng du
kenh duong|phuong kenh duong
kenh giang|xa kenh giang
keo lom|xa keo lom
kha cuu|xa kha cuu
kha phong|xa kha phong
kha son|xa kha son
khac niem|phuong khac niem
khai quang|phuong khai quang
khai son|xa khai son
khai thai|xa khai thai
khai trung|xa khai trung
khai xuan|xa khai xuan
kham duc|thi tran kham duc
kham lang|xa kham lang
kham thanh|xa kham thanh
kham thien|phuong kham thien
khang chien|xa khang chien
khang nhat|xa khang nhat
khang ninh|xa khang ninh
khanh an|xa khanh an
khanh binh dong|xa khanh binh dong
khanh binh tay bac|xa khanh binh tay bac
khanh binh tay|xa khanh binh tay
khanh binh|phuong khanh binh
khanh binh|xa khanh binh
khanh cong|xa khanh cong
khanh cuong|xa khanh cuong
khanh cu|xa khanh cu
khanh dong|xa khanh dong
khanh duong|xa khanh duong
khanh hai|thi tran khanh hai
khanh hai|xa khanh hai
khanh hau|phuong khanh hau
khanh ha|xa khanh ha
khanh hiep|xa khanh hiep
khanh hoa|phuong khanh hoa
khanh hoa|xa khanh hoa
khanh hoi|xa khanh hoi
khanh hong|xa khanh hong
khanh hop|xa khanh hop
khanh hung|xa khanh hung
khanh khe|xa khanh khe
khanh lam|xa khanh lam
khanh loc|xa khanh loc
khanh loi|xa khanh loi
khanh long|xa khanh long
khanh mau|xa khanh mau
khanh nam|xa khanh nam
khanh nhac|xa khanh nhac
khanh phu|xa khanh phu
khanh son|xa khanh son
khanh thanh tan|xa khanh thanh tan
khanh thanh|xa khanh thanh
khanh thien|xa khanh thien
khanh thinh|xa khanh thinh
khanh thuan|xa khanh thuan
khanh thuong|xa khanh thuong
khanh thuy|xa khanh thuy
khanh tien|xa khanh tien
khanh trung|xa khanh trung
khanh van|xa khanh van
khanh vinh yen|xa khanh vinh yen
khanh vinh|thi tran khanh vinh
khanh xuan|phuong khanh xuan
khanh xuan|xa khanh xuan
khanh yen ha|xa khanh yen ha
khanh yen thuong|xa khanh yen thuong
khanh yen trung|xa khanh yen trung
khanh yen|thi tran khanh yen
khao mang|xa khao mang
khau tinh|xa khau tinh
khau vai|xa khau vai
khe mo|xa khe mo
khe sanh|thi tran khe sanh
khe tre|thi tran khe tre
khoai chau|thi tran khoai chau
khoan du|xa khoan du
khoen on|xa khoen on
khoi ky|xa khoi ky
khoi nghia|xa khoi nghia
khong lao|xa khong lao
khuat xa|xa khuat xa
khuc xuyen|phuong khuc xuyen
khue my|phuong khue my
khue ngoc dien|xa khue ngoc dien
khue trung|phuong khue trung
khun ha|xa khun ha
khuon ha|xa khuon ha
khuon lung|xa khuon lung
khuong dinh|phuong khuong dinh
khuong mai|phuong khuong mai
khuong thuong|phuong khuong thuong
khuong trung|phuong khuong trung
khuyen nong|xa khuyen nong
kien an|xa kien an
kien bai|xa kien bai
kien binh|xa kien binh
kien dai|xa kien dai
kien duc|thi tran kien duc
kien giang|thi tran kien giang
kien hung|phuong kien hung
kien khe|thi tran kien khe
kien lao|xa kien lao
kien luong|thi tran kien luong
kien moc|xa kien moc
kien quoc|xa kien quoc
kien thanh|xa kien thanh
kien thiet|xa kien thiet
kien tho|xa kien tho
kien xuong|thi tran kien xuong
kieng phuoc|xa kieng phuoc
kiet son|xa kiet son
kieu ky|xa kieu ky
kim anh|xa kim anh
kim an|xa kim an
kim bai|thi tran kim bai
kim binh|xa kim binh
kim boi|xa kim boi
kim bon|xa kim bon
kim chan|phuong kim chan
kim chinh|xa kim chinh
kim chung|xa kim chung
kim cuc|xa kim cuc
kim dinh|phuong kim dinh
kim dinh|xa kim dinh
kim dong|xa kim dong
kim duc|xa kim duc
kim duong|xa kim duong
kim giang|phuong kim giang
kim hai|xa kim hai
kim hoa|xa kim hoa
kim hy|xa kim hy
kim lan|xa kim lan
kim lap|xa kim lap
kim lien|phuong kim lien
kim lien|xa kim lien
kim linh|xa kim linh
kim loan|xa kim loan
kim long|phuong kim long
kim long|xa kim long
kim lu|xa kim lu
kim ma|phuong kim ma
kim my|xa kim my
kim ngoc|xa kim ngoc
kim noi|xa kim noi
kim no|xa kim no
kim phuong|xa kim phuong
kim phu|xa kim phu
kim quan|xa kim quan
kim song truong|xa kim song truong
kim son|phuong kim son
kim son|thi tran kim son
kim son|xa kim son
kim tan|phuong kim tan
kim tan|thi tran kim tan
kim tan|xa kim tan
kim thach|xa kim thach
kim thai|xa kim thai
kim thanh|xa kim thanh
kim thuong|xa kim thuong
kim thuy|xa kim thuy
kim thu|xa kim thu
kim trung|xa kim trung
kim xa|xa kim xa
kim xuyen|xa kim xuyen
kinh bac|phuong kinh bac
kinh cung|thi tran kinh cung
kinh dinh|phuong kinh dinh
kon chieng|xa kon chieng
kon dao|xa kon dao
kon dong|thi tran kon dong
kon gang|xa kon gang
kon pne|xa kon pne
kon thup|xa kon thup
kong chro|thi tran kong chro
kong htok|xa kong htok
kong long khong|xa kong long khong
kong pla|xa kong pla
kong yang|xa kong yang
krong a|xa krong a
krong buk|xa krong buk
krong jing|xa krong jing
krong klang|thi tran krong klang
krong kmar|thi tran krong kmar
krong nang|thi tran krong nang
krong nang|xa krong nang
krong na|xa krong na
krong no|xa krong no
krong pa|xa krong pa
ky bac|xa ky bac
ky ba|phuong ky ba
ky chau|xa ky chau
ky dong|xa ky dong
ky giang|xa ky giang
ky hai|xa ky hai
ky ha|xa ky ha
ky hoa|xa ky hoa
ky khang|xa ky khang
ky lac|xa ky lac
ky lien|phuong ky lien
ky loi|xa ky loi
ky long|phuong ky long
ky nam|xa ky nam
ky ninh|xa ky ninh
ky phong|xa ky phong
ky phuong|phuong ky phuong
ky phu|xa ky phu
ky son|phuong ky son
ky son|xa ky son
ky tan|xa ky tan
ky tay|xa ky tay
ky thinh|phuong ky thinh
ky tho|xa ky tho
ky thuong|xa ky thuong
ky thu|xa ky thu
ky tien|xa ky tien
ky trinh|phuong ky trinh
ky trung|xa ky trung
ky van|xa ky van
ky xuan|xa ky xuan
la bang|xa la bang
la da|xa la da
la dee|xa la dee
la hai|thi tran la hai
la ha|thi tran la ha
la hien|xa la hien
la khe|phuong la khe
la ngau|xa la ngau
la nga|xa la nga
la nhi thang|xa la nhi thang
la pan tan|xa la pan tan
la phu|xa la phu
la son|xa la son
lac an|xa lac an
lac dao|phuong lac dao
lac dao|xa lac dao
lac duong|thi tran lac duong
lac hoa|xa lac hoa
lac hong|xa lac hong
lac lam|xa lac lam
lac long|xa lac long
lac luong|xa lac luong
lac nong|xa lac nong
lac quoi|xa lac quoi
lac son|xa lac son
lac sy|xa lac sy
lac tanh|thi tran lac tanh
lac tan|xa lac tan
lac thinh|xa lac thinh
lac van|xa lac van
lac ve|xa lac ve
lac vien|phuong lac vien
lac xuan|xa lac xuan
lach tray|phuong lach tray
lai cach|thi tran lai cach
lai dong|xa lai dong
lai ha|xa lai ha
lai hieu|phuong lai hieu
lai hoa|xa lai hoa
lai hung|xa lai hung
lai son|xa lai son
lai thanh|xa lai thanh
lai thieu|phuong lai thieu
lai thuong|xa lai thuong
lai uyen|thi tran lai uyen
lai vung|thi tran lai vung
lai vu|xa lai vu
lai xuan|xa lai xuan
lai yen|xa lai yen
lam ca|xa lam ca
lam cot|xa lam cot
lam dien|xa lam dien
lam dong|xa lam dong
lam dot|xa lam dot
lam giang|xa lam giang
lam hai|xa lam hai
lam ha|phuong lam ha
lam hoa|xa lam hoa
lam hop|xa lam hop
lam kiet|xa lam kiet
lam phu|xa lam phu
lam san|xa lam san
lam son|phuong lam son
lam son|thi tran lam son
lam son|xa lam son
lam tan|xa lam tan
lam thao|thi tran lam thao
lam thao|xa lam thao
lam thuong|xa lam thuong
lam thuy|xa lam thuy
lam trach|xa lam trach
lam trung thuy|xa lam trung thuy
lam vy|xa lam vy
lan gioi|xa lan gioi
lan mau|xa lan mau
lang bien|xa lang bien
lang can|xa lang can
lang chanh|thi tran lang chanh
lang cheu|xa lang cheu
lang cong|xa lang cong
lang co|thi tran lang co
lang dai|xa lang dai
lang giang|xa lang giang
lang ha|phuong lang ha
lang hieu|xa lang hieu
lang khe|xa lang khe
lang lon|xa lang lon
lang minh|xa lang minh
lang mo|xa lang mo
lang ngam|xa lang ngam
lang nhi|xa lang nhi
lang phong|xa lang phong
lang quan|xa lang quan
lang son|xa lang son
lang thanh|xa lang thanh
lang thip|xa lang thip
lang thuong|phuong lang thuong
lang tron|phuong lang tron
lao bao|thi tran lao bao
lao cai|phuong lao cai
lao chai|xa lao chai
lao ho|xa lao ho
lao va chai|xa lao va chai
lao xa phinh|xa lao xa phinh
lap le|xa lap le
lap thach|thi tran lap thach
lap vo|thi tran lap vo
lau thuong|xa lau thuong
lay nua|xa lay nua
le binh|phuong le binh
le chanh|xa le chanh
le chi|xa le chi
le chung|xa le chung
le dai hanh|phuong le dai hanh
le hoa|xa le hoa
le hong phong|phuong le hong phong
le hong|xa le hong
le ho|xa le ho
le lai|xa le lai
le loi|phuong le loi
le loi|xa le loi
le mao|phuong le mao
le minh xuan|xa le minh xuan
le my|xa le my
le ninh|xa le ninh
le thanh nghi|phuong le thanh nghi
le thanh|xa le thanh
le thien|xa le thien
le tri|xa le tri
le vien|xa le vien
le xa|xa le xa
leng su sin|xa leng su sin
lich hoi thuong|thi tran lich hoi thuong
lich hoi thuong|xa lich hoi thuong
liem can|xa liem can
liem chinh|phuong liem chinh
liem chung|xa liem chung
liem hai|xa liem hai
liem phong|xa liem phong
liem phu|xa liem phu
liem son|xa liem son
liem thuan|xa liem thuan
liem thuy|xa liem thuy
liem tiet|xa liem tiet
liem tuc|xa liem tuc
liem tuyen|xa liem tuyen
lien am|xa lien am
lien bao|phuong lien bao
lien bao|xa lien bao
lien bat|xa lien bat
lien chau|xa lien chau
lien chung|xa lien chung
lien dam|xa lien dam
lien giang|xa lien giang
lien ha|xa lien ha
lien hiep|xa lien hiep
lien hoa|xa lien hoa
lien hoi|xa lien hoi
lien hong|xa lien hong
lien hop|xa lien hop
lien huong|thi tran lien huong
lien khe|xa lien khe
lien loc|xa lien loc
lien mac|phuong lien mac
lien mac|xa lien mac
lien minh|xa lien minh
lien nghia|thi tran lien nghia
lien nghia|xa lien nghia
lien ninh|xa lien ninh
lien phuong|xa lien phuong
lien quan|thi tran lien quan
lien sang|xa lien sang
lien son|thi tran lien son
lien son|xa lien son
lien thanh|xa lien thanh
lien thuy|xa lien thuy
lien trach|xa lien trach
lien trung|xa lien trung
lien truong|xa lien truong
lien vi|xa lien vi
lieng sronh|xa lieng sronh
liep te|xa liep te
liep tuyet|xa liep tuyet
lieu de|thi tran lieu de
lieu do|xa lieu do
lieu giai|phuong lieu giai
lieu tu|xa lieu tu
lieu xa|xa lieu xa
linh chieu|phuong linh chieu
linh dong|phuong linh dong
linh hai|xa linh hai
linh ho|xa linh ho
linh huynh|xa linh huynh
linh nam|phuong linh nam
linh phu|xa linh phu
linh son|xa linh son
linh tay|phuong linh tay
linh thong|xa linh thong
linh toai|xa linh toai
linh trung|phuong linh trung
linh truong|xa linh truong
linh xuan|phuong linh xuan
lo 25|xa lo 25
lo giang|xa lo giang
lo ku|xa lo ku
lo pang|xa lo pang
lo son|xa lo son
loan my|xa loan my
loc an|xa loc an
loc bac|xa loc bac
loc bao|xa loc bao
loc binh|thi tran loc binh
loc binh|xa loc binh
loc bon|xa loc bon
loc chau|xa loc chau
loc dien|xa loc dien
loc duc|xa loc duc
loc giang|xa loc giang
loc ha|phuong loc ha
loc ha|thi tran loc ha
loc hiep|xa loc hiep
loc hoa|phuong loc hoa
loc hoa|xa loc hoa
loc hung|phuong loc hung
loc hung|xa loc hung
loc khanh|xa loc khanh
loc lam|xa loc lam
loc nam|xa loc nam
loc ngai|xa loc ngai
loc nga|xa loc nga
loc ninh|thi tran loc ninh
loc ninh|xa loc ninh
loc phat|phuong loc phat
loc phu|xa loc phu
loc quang|xa loc quang
loc son|phuong loc son
loc son|xa loc son
loc tan|xa loc tan
loc thai|xa loc thai
loc thang|thi tran loc thang
loc thanh|xa loc thanh
loc thien|xa loc thien
loc thinh|xa loc thinh
loc tho|phuong loc tho
loc thuan|xa loc thuan
loc thuy|xa loc thuy
loc tien|phuong loc tien
loc tien|xa loc tien
loc tri|xa loc tri
loc vinh|xa loc vinh
loc vuong|phuong loc vuong
loc yen|xa loc yen
loi an|xa loi an
loi bac|xa loi bac
loi binh nhon|xa loi binh nhon
loi hai|xa loi hai
loi thuan|xa loi thuan
long anh|xa long anh
long an|xa long an
long bien|phuong long bien
long binh dien|xa long binh dien
long binh tan|phuong long binh tan
long binh|phuong long binh
long binh|thi tran long binh
long binh|xa long binh
long cang|xa long cang
long chanh|xa long chanh
long chau|phuong long chau
long chau|xa long chau
long chu|xa long chu
long coc|xa long coc
long dien a|xa long dien a
long dien b|xa long dien b
long dien dong a|xa long dien dong a
long dien dong|xa long dien dong
long dien tay|xa long dien tay
long dien|thi tran long dien
long dien|xa long dien
long dinh|xa long dinh
long dong|xa long dong
long duc|xa long duc
long giang|xa long giang
long giao|xa long giao
long hai|thi tran long hai
long hai|xa long hai
long hau|xa long hau
long ha|xa long ha
long he|xa long he
long hiep|xa long hiep
long hoa|phuong long hoa
long hoa|xa long hoa
long ho|thi tran long ho
long hung a|xa long hung a
long hung b|xa long hung b
long hung|phuong long hung
long hung|xa long hung
long huong|phuong long huong
long huu dong|xa long huu dong
long huu tay|xa long huu tay
long huu|xa long huu
long khanh a|xa long khanh a
long khanh b|xa long khanh b
long khanh|xa long khanh
long khe|xa long khe
long kien|xa long kien
long luong|xa long luong
long mai|xa long mai
long mon|xa long mon
long my|xa long my
long nguyen|xa long nguyen
long phieng|xa long phieng
long phung|xa long phung
long phuoc|phuong long phuoc
long phuoc|xa long phuoc
long phu|phuong long phu
long phu|thi tran long phu
long phu|xa long phu
long sap|xa long sap
long son|phuong long son
long son|xa long son
long tam|phuong long tam
long tan|xa long tan
long thang|xa long thang
long thanh bac|phuong long thanh bac
long thanh my|phuong long thanh my
long thanh nam|xa long thanh nam
long thanh trung|phuong long thanh trung
long thanh|phuong long thanh
long thanh|thi tran long thanh
long thanh|xa long thanh
long thoi|xa long thoi
long tho|xa long tho
long thuan|xa long thuan
long thuong|xa long thuong
long thuy|phuong long thuy
long tien|xa long tien
long toan|phuong long toan
long toan|xa long toan
long trach|xa long trach
long tri a|xa long tri a
long tri|xa long tri
long trung|xa long trung
long truong|phuong long truong
long tuyen|phuong long tuyen
long vinh|xa long vinh
long xa|xa long xa
long xuyen|phuong long xuyen
long xuyen|xa long xuyen
luan gioi|xa luan gioi
luan khe|xa luan khe
luan thanh|xa luan thanh
luc ba|xa luc ba
luc binh|xa luc binh
luc da|xa luc da
luc hanh|xa luc hanh
luc hon|xa luc hon
luc son|xa luc son
luc sy thanh|xa luc sy thanh
lung cai|xa lung cai
lung cao|xa lung cao
lung chinh|xa lung chinh
lung cu|xa lung cu
lung hoa|xa lung hoa
lung ho|xa lung ho
lung khau nhin|xa lung khau nhin
lung nam|xa lung nam
lung niem|xa lung niem
lung phinh|xa lung phinh
lung phin|xa lung phin
lung pu|xa lung pu
lung tam|xa lung tam
lung tao|xa lung tao
lung thang|xa lung thang
lung than|xa lung than
lung thau|xa lung thau
lung vai|xa lung vai
luong an tra|xa luong an tra
luong bang|thi tran luong bang
luong bang|xa luong bang
luong binh|xa luong binh
luong can|xa luong can
luong dien|xa luong dien
luong hoa a|xa luong hoa a
luong hoa lac|xa luong hoa lac
luong hoa|xa luong hoa
luong khanh thien|phuong luong khanh thien
luong lo|xa luong lo
luong minh|xa luong minh
luong mong|xa luong mong
luong nang|xa luong nang
luong nghia|xa luong nghia
luong ngoai|xa luong ngoai
luong nha|xa luong nha
luong ninh|xa luong ninh
luong noi|xa luong noi
luong phi|xa luong phi
luong phong|xa luong phong
luong phu|xa luong phu
luong quoi|xa luong quoi
luong son|phuong luong son
luong son|thi tran luong son
luong son|xa luong son
luong tai|xa luong tai
luong tam|xa luong tam
luong the tran|xa luong the tran
luong thien|xa luong thien
luong thinh|xa luong thinh
luong thong|xa luong thong
luong thuong|xa luong thuong
luong trung|xa luong trung
luong vuong|xa luong vuong
luu hoang|xa luu hoang
luu kiem|xa luu kiem
luu kien|xa luu kien
luu ky|xa luu ky
luu nghiep anh|xa luu nghiep anh
luu phuong|xa luu phuong
luu son|xa luu son
luu vinh son|xa luu vinh son
ly bon|xa ly bon
ly hoc|xa ly hoc
ly nhan|xa ly nhan
ly nhon|xa ly nhon
ly quoc|xa ly quoc
ly thai to|phuong ly thai to
ly thanh|xa ly thanh
ly thuong kiet|phuong ly thuong kiet
ly thuong kiet|xa ly thuong kiet
ly trach|xa ly trach
ly van lam|xa ly van lam
ma ba|xa ma ba
ma cooi|xa ma cooi
ma da guoi|thi tran ma da guoi
ma da guoi|xa ma da guoi
ma da|xa ma da
ma lam|thi tran ma lam
ma le|xa ma le
ma ly pho|xa ma ly pho
ma noi|xa ma noi
ma quai|xa ma quai
ma thanh|xa ma thanh
ma thi ho|xa ma thi ho
mai chau|thi tran mai chau
mai dam|thi tran mai dam
mai dich|phuong mai dich
mai dinh|xa mai dinh
mai dong|phuong mai dong
mai dong|xa mai dong
mai ha|xa mai ha
mai hich|xa mai hich
mai hoa|xa mai hoa
mai hung|phuong mai hung
mai lam|phuong mai lam
mai lam|xa mai lam
mai lap|xa mai lap
mai long|xa mai long
mai pha|xa mai pha
mai phu|xa mai phu
mai sao|xa mai sao
mai son|xa mai son
mai thuy|xa mai thuy
mai trung|xa mai trung
man duc|thi tran man duc
man lan|xa man lan
man thai|phuong man thai
mang buk|xa mang buk
mang canh|xa mang canh
mang den|thi tran mang den
mang ri|xa mang ri
mang to|xa mang to
mao dien|xa mao dien
mao khe|phuong mao khe
mau a|thi tran mau a
mau dong|xa mau dong
mau duc|xa mau duc
mau due|xa mau due
mau lam|xa mau lam
mau long|xa mau long
mau son|xa mau son
may chai|phuong may chai
may to|phuong may to
me linh|xa me linh
me pu|xa me pu
me so|xa me so
me tri|phuong me tri
meo vac|thi tran meo vac
mi hoa|xa mi hoa
mien doi|xa mien doi
minh an|phuong minh an
minh an|xa minh an
minh bao|xa minh bao
minh cam|xa minh cam
minh chau|xa minh chau
minh chuan|xa minh chuan
minh coi|xa minh coi
minh cuong|xa minh cuong
minh dai|xa minh dai
minh dan|xa minh dan
minh dao|xa minh dao
minh dieu|xa minh dieu
minh duc|phuong minh duc
minh duc|thi tran minh duc
minh duc|xa minh duc
minh hac|xa minh hac
minh hai|xa minh hai
minh hiep|xa minh hiep
minh hoang|xa minh hoang
minh hoa|xa minh hoa
minh hop|xa minh hop
minh hung|xa minh hung
minh huong|xa minh huong
minh khai|phuong minh khai
minh khai|xa minh khai
minh khoi|xa minh khoi
minh khuong|xa minh khuong
minh lang|xa minh lang
minh lap|xa minh lap
minh loc|xa minh loc
minh long|xa minh long
minh luong|thi tran minh luong
minh luong|xa minh luong
minh nghia|xa minh nghia
minh ngoc|xa minh ngoc
minh nong|phuong minh nong
minh phuong|phuong minh phuong
minh phuong|xa minh phuong
minh phu|xa minh phu
minh quang|xa minh quang
minh quan|xa minh quan
minh son|xa minh son
minh tam|xa minh tam
minh tan|phuong minh tan
minh tan|xa minh tan
minh thang|xa minh thang
minh thanh|phuong minh thanh
minh thanh|xa minh thanh
minh thuan|xa minh thuan
minh tien|xa minh tien
minh tri|xa minh tri
minh xuan|phuong minh xuan
minh xuan|xa minh xuan
mo cay|thi tran mo cay
mo che|phuong mo che
mo cong|xa mo cong
mo dao|xa mo dao
mo de|xa mo de
mo duc|thi tran mo duc
mo lao|phuong mo lao
mo o|xa mo o
mo rai|xa mo rai
mo si san|xa mo si san
mo vang|xa mo vang
moc bac|xa moc bac
moc chau|thi tran moc chau
moc nam|xa moc nam
mon son|xa mon son
mong an|xa mong an
mong duong|phuong mong duong
mong hoa|xa mong hoa
mong son|xa mong son
mong tho a|xa mong tho a
mong tho b|xa mong tho b
mong tho|xa mong tho
mot ngan|thi tran mot ngan
mu cang chai|thi tran mu cang chai
mu ca|xa mu ca
mu sang|xa mu sang
mui ne|phuong mui ne
mun chung|xa mun chung
muoi noi|xa muoi noi
muong ai|xa muong ai
muong ang|thi tran muong ang
muong bam|xa muong bam
muong bang|xa muong bang
muong bon|xa muong bon
muong bo|xa muong bo
muong bu|xa muong bu
muong cai|xa muong cai
muong cang|xa muong cang
muong chanh|xa muong chanh
muong cha|thi tran muong cha
muong chieng|xa muong chieng
muong chien|xa muong chien
muong chum|xa muong chum
muong coi|xa muong coi
muong dang|xa muong dang
muong do|xa muong do
muong dun|xa muong dun
muong e|xa muong e
muong giang|xa muong giang
muong gion|xa muong gion
muong hoa|xa muong hoa
muong hoong|xa muong hoong
muong hum|xa muong hum
muong hung|xa muong hung
muong khieng|xa muong khieng
muong khoa|xa muong khoa
muong khong|xa muong khong
muong khuong|thi tran muong khuong
muong kim|xa muong kim
muong lai|xa muong lai
muong lam|xa muong lam
muong lang|xa muong lang
muong lan|xa muong lan
muong lat|thi tran muong lat
muong leo|xa muong leo
muong loi|xa muong loi
muong long|xa muong long
muong luan|xa muong luan
muong lum|xa muong lum
muong ly|xa muong ly
muong man|xa muong man
muong men|xa muong men
muong min|xa muong min
muong mit|xa muong mit
muong mo|xa muong mo
muong mun|xa muong mun
muong muon|xa muong muon
muong nha|xa muong nha
muong nhe|xa muong nhe
muong noc|xa muong noc
muong phang|xa muong phang
muong pon|xa muong pon
muong sai|xa muong sai
muong sang|xa muong sang
muong so|xa muong so
muong te|thi tran muong te
muong te|xa muong te
muong thai|xa muong thai
muong thanh|phuong muong thanh
muong than|xa muong than
muong thin|xa muong thin
muong tip|xa muong tip
muong toong|xa muong toong
muong trai|xa muong trai
muong tung|xa muong tung
muong va|xa muong va
muong vi|xa muong vi
muong xen|thi tran muong xen
my an hung a|xa my an hung a
my an hung b|xa my an hung b
my an|phuong my an
my an|thi tran my an
my an|xa my an
my bang|xa my bang
my binh|phuong my binh
my binh|xa my binh
my cam|xa my cam
my cat|xa my cat
my chanh tay|xa my chanh tay
my chanh|xa my chanh
my chau|xa my chau
my dinh 1|phuong my dinh 1
my dinh 2|phuong my dinh 2
my dong|phuong my dong
my dong|xa my dong
my do|phuong my do
my duc dong|xa my duc dong
my duc tay|xa my duc tay
my duc|phuong my duc
my duc|xa my duc
my gia|xa my gia
my hai|phuong my hai
my hanh bac|xa my hanh bac
my hanh dong|xa my hanh dong
my hanh nam|xa my hanh nam
my hanh trung|xa my hanh trung
my ha|xa my ha
my hiep son|xa my hiep son
my hiep|xa my hiep
my hoa hung|xa my hoa hung
my hoa|phuong my hoa
my hoa|xa my hoa
my hoi dong|xa my hoi dong
my hoi|xa my hoi
my hung|xa my hung
my huong|phuong my huong
my huong|xa my huong
my khanh|xa my khanh
my lac|xa my lac
my lam|phuong my lam
my lam|xa my lam
my le|xa my le
my loc|thi tran my loc
my loc|xa my loc
my loi a|xa my loi a
my loi b|xa my loi b
my loi|xa my loi
my long bac|xa my long bac
my long nam|xa my long nam
my long|phuong my long
my long|thi tran my long
my long|xa my long
my lung|xa my lung
my luong|thi tran my luong
my luong|xa my luong
my ly|xa my ly
my ngai|xa my ngai
my nhon|xa my nhon
my phong|xa my phong
my phu dong|xa my phu dong
my phuc|xa my phuc
my phuoc tay|xa my phuoc tay
my phuoc|phuong my phuoc
my phuoc|thi tran my phuoc
my phuoc|xa my phuoc
my phuong|xa my phuong
my phu|phuong my phu
my phu|xa my phu
my quang|xa my quang
my quoi|xa my quoi
my quy dong|xa my quy dong
my quy tay|xa my quy tay
my quy|phuong my quy
my quy|xa my quy
my son|xa my son
my tai|xa my tai
my tan|xa my tan
my thai|xa my thai
my thang|xa my thang
my thanh an|xa my thanh an
my thanh bac|xa my thanh bac
my thanh dong|xa my thanh dong
my thanh nam|xa my thanh nam
my thanh tay|xa my thanh tay
my thanh trung|xa my thanh trung
my thanh|phuong my thanh
my thanh|xa my thanh
my thinh|xa my thinh
my thoi|phuong my thoi
my tho|thi tran my tho
my tho|xa my tho
my thuan|xa my thuan
my thuy|xa my thuy
my tien|xa my tien
my tinh an|xa my tinh an
my trach|xa my trach
my tra|xa my tra
my trinh|xa my trinh
my trung|xa my trung
my tu|xa my tu
my xa|phuong my xa
my xuan|phuong my xuan
my xuong|xa my xuong
my xuyen|phuong my xuyen
my xuyen|thi tran my xuyen
my yen|xa my yen
n'thol ha|nthol ha|xa n'thol ha|nthol ha
n.t phong hai|thi tran n.t phong hai
na bung|xa na bung
na chi|xa na chi
na co sa|xa na co sa
na duong|thi tran na duong
na hang|thi tran na hang
na hau|xa na hau
na hoi|xa na hoi
na hy|xa na hy
na khe|xa na khe
na khoa|xa na khoa
na khuong|xa na khuong
na lay|phuong na lay
na loi|xa na loi
na mao|xa na mao
na meo|xa na meo
na muong|xa na muong
na nghiu|xa na nghiu
na ngoi|xa na ngoi
na nhan|xa na nhan
na ot|xa na ot
na phac|thi tran na phac
na phon|xa na phon
na po|xa na po
na sam|thi tran na sam
na sang|xa na sang
na say|xa na say
na son|xa na son
na tam|xa na tam
na tau|xa na tau
na tong|xa na tong
na u|xa na u
nai hien dong|phuong nai hien dong
nam anh|xa nam anh
nam ban|thi tran nam ban
nam ban|xa nam ban
nam binh|phuong nam binh
nam binh|xa nam binh
nam bung|xa nam bung
nam can|thi tran nam can
nam can|xa nam can
nam cao|xa nam cao
nam cat tien|xa nam cat tien
nam cat|xa nam cat
nam chac|xa nam chac
nam chay|xa nam chay
nam cha|xa nam cha
nam chinh|xa nam chinh
nam chua|xa nam chua
nam co|xa nam co
nam cuoi|xa nam cuoi
nam cuong|phuong nam cuong
nam cuong|xa nam cuong
nam dan|thi tran nam dan
nam dan|xa nam dan
nam da|xa nam da
nam det|xa nam det
nam dich|xa nam dich
nam dien|xa nam dien
nam dong|phuong nam dong
nam dong|xa nam dong
nam duong|phuong nam duong
nam duong|xa nam duong
nam du|xa nam du
nam et|xa nam et
nam giai|xa nam giai
nam giang|thi tran nam giang
nam giang|xa nam giang
nam gion|xa nam gion
nam hai|phuong nam hai
nam hai|xa nam hai
nam hang|xa nam hang
nam han|xa nam han
nam ha|phuong nam ha
nam ha|xa nam ha
nam hoa|phuong nam hoa
nam hoa|xa nam hoa
nam hong|phuong nam hong
nam hong|xa nam hong
nam hung|xa nam hung
nam ka|xa nam ka
nam ke|xa nam ke
nam khanh|xa nam khanh
nam khan|xa nam khan
nam khao|xa nam khao
nam khat|xa nam khat
nam khe|phuong nam khe
nam khoa|xa nam khoa
nam kim|xa nam kim
nam lanh|xa nam lanh
nam lau|xa nam lau
nam lich|xa nam lich
nam linh|xa nam linh
nam loi|xa nam loi
nam luc|xa nam luc
nam lu|xa nam lu
nam ly|phuong nam ly
nam manh|xa nam manh
nam man|xa nam man
nam mau|xa nam mau
nam ma|xa nam ma
nam mon|xa nam mon
nam muoi|xa nam muoi
nam my|xa nam my
nam n'dir|nam ndir|xa nam n'dir|nam ndir
nam n'jang|nam njang|xa nam n'jang|nam njang
nam nen|xa nam nen
nam ngan|phuong nam ngan
nam nghia|xa nam nghia
nam nhoong|xa nam nhoong
nam nhun|thi tran nam nhun
nam nhu|xa nam nhu
nam ninh|xa nam ninh
nam nung|xa nam nung
nam pam|xa nam pam
nam phong|xa nam phong
nam phuc thang|xa nam phuc thang
nam phuoc|thi tran nam phuoc
nam phuong tien|xa nam phuong tien
nam phu|xa nam phu
nam pi|xa nam pi
nam pung|xa nam pung
nam quang|xa nam quang
nam quan|xa nam quan
nam rang|xa nam rang
nam sach|thi tran nam sach
nam son|phuong nam son
nam son|xa nam son
nam so|xa nam so
nam tam|xa nam tam
nam tan|xa nam tan
nam thai a|xa nam thai a
nam thai son|xa nam thai son
nam thai|xa nam thai
nam thang|xa nam thang
nam thanh|phuong nam thanh
nam thanh|xa nam thanh
nam tha|xa nam tha
nam thinh|xa nam thinh
nam thuong|xa nam thuong
nam tien|xa nam tien
nam tin|xa nam tin
nam toan|xa nam toan
nam trach|xa nam trach
nam trieu|xa nam trieu
nam trung|xa nam trung
nam tuan|xa nam tuan
nam ty|xa nam ty
nam van|xa nam van
nam viem|phuong nam viem
nam vi|xa nam vi
nam xay|xa nam xay
nam xe|xa nam xe
nam xuan|xa nam xuan
nam yang|xa nam yang
nam yen|xa nam yen
nan ma|xa nan ma
nan san|xa nan san
nan xin|xa nan xin
nang don|xa nang don
nang kha|xa nang kha
nang mau|thi tran nang mau
nang tinh|phuong nang tinh
nanh nghe|xa nanh nghe
nga an|xa nga an
nga bach|xa nga bach
nga bay|phuong nga bay
nga dien|xa nga dien
nga giap|xa nga giap
nga hai|xa nga hai
nga hoang|xa nga hoang
nga lien|xa nga lien
nga my|xa nga my
nga phuong|xa nga phuong
nga phu|xa nga phu
nga quan|xa nga quan
nga sau|thi tran nga sau
nga son|thi tran nga son
nga tan|xa nga tan
nga thach|xa nga thach
nga thai|xa nga thai
nga thang|xa nga thang
nga thanh|xa nga thanh
nga thien|xa nga thien
nga thuy|xa nga thuy
nga tien|xa nga tien
nga trung|xa nga trung
nga truong|xa nga truong
nga tu so|phuong nga tu so
nga van|xa nga van
nga vinh|xa nga vinh
nga yen|xa nga yen
ngai dang|xa ngai dang
ngai giao|thi tran ngai giao
ngai hung|xa ngai hung
ngai tu|xa ngai tu
ngai xuyen|xa ngai xuyen
ngam dang vai|xa ngam dang vai
ngam la|xa ngam la
ngan dua|thi tran ngan dua
ngan thuy|xa ngan thuy
nghi an|xa nghi an
nghi cong bac|xa nghi cong bac
nghi cong nam|xa nghi cong nam
nghi dien|xa nghi dien
nghi dong|xa nghi dong
nghi duc|xa nghi duc
nghi hai|phuong nghi hai
nghi hoa|phuong nghi hoa
nghi hoa|xa nghi hoa
nghi hung|xa nghi hung
nghi huong|phuong nghi huong
nghi kieu|xa nghi kieu
nghi kim|xa nghi kim
nghi lam|xa nghi lam
nghi lien|xa nghi lien
nghi long|xa nghi long
nghi my|xa nghi my
nghi phong|xa nghi phong
nghi phuong|xa nghi phuong
nghi phu|xa nghi phu
nghi quang|xa nghi quang
nghi son|xa nghi son
nghi tan|phuong nghi tan
nghi thach|xa nghi thach
nghi thai|xa nghi thai
nghi thiet|xa nghi thiet
nghi thinh|xa nghi thinh
nghi thuan|xa nghi thuan
nghi thuy|phuong nghi thuy
nghi thu|phuong nghi thu
nghi tien|xa nghi tien
nghi trung|xa nghi trung
nghi truong|xa nghi truong
nghi van|xa nghi van
nghi xa|xa nghi xa
nghi xuan|xa nghi xuan
nghi yen|xa nghi yen
nghia an|xa nghia an
nghia binh|xa nghia binh
nghia chanh|phuong nghia chanh
nghia chau|xa nghia chau
nghia dan|thi tran nghia dan
nghia dan|xa nghia dan
nghia dao|xa nghia dao
nghia dien|xa nghia dien
nghia dong|xa nghia dong
nghia do|phuong nghia do
nghia do|xa nghia do
nghia duc|phuong nghia duc
nghia duc|xa nghia duc
nghia dung|xa nghia dung
nghia hai|xa nghia hai
nghia hanh|xa nghia hanh
nghia ha|xa nghia ha
nghia hiep|xa nghia hiep
nghia hieu|xa nghia hieu
nghia hoan|xa nghia hoan
nghia hoa|xa nghia hoa
nghia hoi|xa nghia hoi
nghia hong|xa nghia hong
nghia hop|xa nghia hop
nghia hung|xa nghia hung
nghia huong|xa nghia huong
nghia khanh|xa nghia khanh
nghia ky|xa nghia ky
nghia lac|xa nghia lac
nghia lam|xa nghia lam
nghia loc|xa nghia loc
nghia loi|xa nghia loi
nghia long|xa nghia long
nghia lo|phuong nghia lo
nghia lo|xa nghia lo
nghia mai|xa nghia mai
nghia minh|xa nghia minh
nghia my|xa nghia my
nghia ninh|xa nghia ninh
nghia phong|xa nghia phong
nghia phuc|xa nghia phuc
nghia phuong|xa nghia phuong
nghia phu|phuong nghia phu
nghia phu|xa nghia phu
nghia son|xa nghia son
nghia tam|xa nghia tam
nghia tan|phuong nghia tan
nghia tan|xa nghia tan
nghia ta|xa nghia ta
nghia thai|xa nghia thai
nghia thang|xa nghia thang
nghia thanh|phuong nghia thanh
nghia thanh|xa nghia thanh
nghia thinh|xa nghia thinh
nghia tho|xa nghia tho
nghia thuan|xa nghia thuan
nghia thuong|xa nghia thuong
nghia tien|xa nghia tien
nghia trung|phuong nghia trung
nghia trung|xa nghia trung
nghia tru|xa nghia tru
nghia xa|phuong nghia xa
nghia xuan|xa nghia xuan
nghia yen|xa nghia yen
nghiem xuyen|xa nghiem xuyen
nghien loan|xa nghien loan
nghinh tuong|xa nghinh tuong
ngo dong|thi tran ngo dong
ngo luong|xa ngo luong
ngo may|phuong ngo may
ngo may|thi tran ngo may
ngo quyen|phuong ngo quyen
ngo quyen|xa ngo quyen
ngo xa|xa ngo xa
ngoc bien|xa ngoc bien
ngoc chanh|xa ngoc chanh
ngoc chan|xa ngoc chan
ngoc chau|phuong ngoc chau
ngoc chau|xa ngoc chau
ngoc chien|xa ngoc chien
ngoc chuc|xa ngoc chuc
ngoc con|xa ngoc con
ngoc dao|xa ngoc dao
ngoc dinh|xa ngoc dinh
ngoc dong|xa ngoc dong
ngoc duong|xa ngoc duong
ngoc ha|phuong ngoc ha
ngoc hiep|phuong ngoc hiep
ngoc hoa|xa ngoc hoa
ngoc hoi|xa ngoc hoi
ngoc khanh|phuong ngoc khanh
ngoc khe|xa ngoc khe
ngoc ky|xa ngoc ky
ngoc lac|thi tran ngoc lac
ngoc lam|phuong ngoc lam
ngoc lam|xa ngoc lam
ngoc lap|xa ngoc lap
ngoc lau|xa ngoc lau
ngoc lay|xa ngoc lay
ngoc lien|xa ngoc lien
ngoc liep|xa ngoc liep
ngoc linh|xa ngoc linh
ngoc long|xa ngoc long
ngoc luong|xa ngoc luong
ngoc lu|xa ngoc lu
ngoc ly|xa ngoc ly
ngoc minh|xa ngoc minh
ngoc my|xa ngoc my
ngoc phai|xa ngoc phai
ngoc phung|xa ngoc phung
ngoc quan|xa ngoc quan
ngoc son|phuong ngoc son
ngoc son|xa ngoc son
ngoc tao|xa ngoc tao
ngoc thanh|xa ngoc thanh
ngoc thien|xa ngoc thien
ngoc thuan|xa ngoc thuan
ngoc thuy|phuong ngoc thuy
ngoc to|xa ngoc to
ngoc trao|phuong ngoc trao
ngoc trao|xa ngoc trao
ngoc trung|xa ngoc trung
ngoc van|xa ngoc van
ngoc vung|xa ngoc vung
ngoc xa|xa ngoc xa
ngoc xuan|phuong ngoc xuan
ngoc xuyen|phuong ngoc xuyen
ngoc yeu|xa ngoc yeu
ngoi a|xa ngoi a
ngoi cay|xa ngoi cay
ngok bay|xa ngok bay
ngok reo|xa ngok reo
ngok tem|xa ngok tem
ngok tu|xa ngok tu
ngok wang|xa ngok wang
ngu chi son|xa ngu chi son
ngu doan|xa ngu doan
ngu hiep|xa ngu hiep
ngu hoa|xa ngu hoa
ngu hung|xa ngu hung
ngu kien|xa ngu kien
ngu lac|xa ngu lac
ngu lao|xa ngu lao
ngu loc|xa ngu loc
ngu phuc|xa ngu phuc
ngu phung|xa ngu phung
ngu thai|xa ngu thai
ngu thuy bac|xa ngu thuy bac
ngu thuy|xa ngu thuy
nguyen an ninh|phuong nguyen an ninh
nguyen binh|phuong nguyen binh
nguyen binh|thi tran nguyen binh
nguyen cu trinh|phuong nguyen cu trinh
nguyen du|phuong nguyen du
nguyen giap|xa nguyen giap
nguyen hoa|xa nguyen hoa
nguyen huan|xa nguyen huan
nguyen hue|xa nguyen hue
nguyen khe|xa nguyen khe
nguyen ly|xa nguyen ly
nguyen nghiem|phuong nguyen nghiem
nguyen phich|xa nguyen phich
nguyen phuc|phuong nguyen phuc
nguyen phuc|xa nguyen phuc
nguyen thai binh|phuong nguyen thai binh
nguyen thai hoc|phuong nguyen thai hoc
nguyen thi minh khai|phuong nguyen thi minh khai
nguyen trai|phuong nguyen trai
nguyen trai|xa nguyen trai
nguyen trung truc|phuong nguyen trung truc
nguyen uy|xa nguyen uy
nguyen van cu|phuong nguyen van cu
nguyen van thanh|xa nguyen van thanh
nguyen viet khai|xa nguyen viet khai
nguyen xa|xa nguyen xa
nguyet an|xa nguyet an
nguyet duc|xa nguyet duc
nguyet hoa|xa nguyet hoa
nha bang|thi tran nha bang
nha be|thi tran nha be
nha bich|xa nha bich
nha long|xa nha long
nha mat|phuong nha mat
nha nam|thi tran nha nam
nhac ky|xa nhac ky
nham bien|thi tran nham bien
nhan binh|xa nhan binh
nhan chinh|phuong nhan chinh
nhan chinh|xa nhan chinh
nhan co|xa nhan co
nhan dao|xa nhan dao
nhan hoa|phuong nhan hoa
nhan hoa|xa nhan hoa
nhan hue|xa nhan hue
nhan khang|xa nhan khang
nhan la|xa nhan la
nhan ly|xa nhan ly
nhan mon|xa nhan mon
nhan muc|xa nhan muc
nhan my|xa nhan my
nhan nghia|xa nhan nghia
nhan quyen|xa nhan quyen
nhan son|xa nhan son
nhan thang|xa nhan thang
nhan thanh|xa nhan thanh
nhan thinh|xa nhan thinh
nhan trach|xa nhan trach
nhao son|xa nhao son
nhat hoa|xa nhat hoa
nhat quang|xa nhat quang
nhat tan|phuong nhat tan
nhat tan|xa nhat tan
nhat tien|xa nhat tien
nhat tuu|xa nhat tuu
nhi binh|xa nhi binh
nhi chau|phuong nhi chau
nhi ha|xa nhi ha
nhi khe|xa nhi khe
nhi long phu|xa nhi long phu
nhi long|xa nhi long
nhi my|phuong nhi my
nhi my|xa nhi my
nhi quy|xa nhi quy
nhi son|xa nhi son
nhi thanh|xa nhi thanh
nhi truong|xa nhi truong
nho quan|thi tran nho quan
nhon ai|xa nhon ai
nhon an|xa nhon an
nhon binh|phuong nhon binh
nhon binh|xa nhon binh
nhon chau|xa nhon chau
nhon duc|xa nhon duc
nhon hai|xa nhon hai
nhon hanh|xa nhon hanh
nhon hau|xa nhon hau
nhon hoa lap|xa nhon hoa lap
nhon hoa|phuong nhon hoa
nhon hoa|thi tran nhon hoa
nhon hoa|xa nhon hoa
nhon hoi|xa nhon hoi
nhon hung|phuong nhon hung
nhon hung|xa nhon hung
nhon khanh|xa nhon khanh
nhon loc|xa nhon loc
nhon ly|xa nhon ly
nhon mai|xa nhon mai
nhon my|xa nhon my
nhon nghia a|xa nhon nghia a
nhon nghia|xa nhon nghia
nhon ninh|xa nhon ninh
nhon phong|xa nhon phong
nhon phuc|xa nhon phuc
nhon phu|phuong nhon phu
nhon phu|xa nhon phu
nhon son|xa nhon son
nhon tan|xa nhon tan
nhon thanh trung|xa nhon thanh trung
nhon thanh|phuong nhon thanh
nhon thanh|xa nhon thanh
nhon tho|xa nhon tho
nhu co|xa nhu co
nhu han|xa nhu han
nhu hoa|xa nhu hoa
nhu khe|xa nhu khe
nhu quynh|thi tran nhu quynh
nhu thuy|xa nhu thuy
nhuan duc|xa nhuan duc
nhuan phu tan|xa nhuan phu tan
nhuan trach|xa nhuan trach
nhue duong|xa nhue duong
nhut chanh|xa nhut chanh
nhut ninh|xa nhut ninh
niem nghia|phuong niem nghia
niem son|xa niem son
niem tong|xa niem tong
ninh an|xa ninh an
ninh binh|xa ninh binh
ninh cuong|thi tran ninh cuong
ninh dan|xa ninh dan
ninh da|phuong ninh da
ninh diem|phuong ninh diem
ninh dien|xa ninh dien
ninh dong|xa ninh dong
ninh duong|phuong ninh duong
ninh giang|phuong ninh giang
ninh giang|thi tran ninh giang
ninh giang|xa ninh giang
ninh gia|xa ninh gia
ninh hai|phuong ninh hai
ninh hai|xa ninh hai
ninh ha|phuong ninh ha
ninh hiep|phuong ninh hiep
ninh hiep|xa ninh hiep
ninh hoa|xa ninh hoa
ninh hung|xa ninh hung
ninh ich|xa ninh ich
ninh khang|xa ninh khang
ninh khanh|phuong ninh khanh
ninh lai|xa ninh lai
ninh loan|xa ninh loan
ninh loc|xa ninh loc
ninh my|xa ninh my
ninh nhat|xa ninh nhat
ninh phong|phuong ninh phong
ninh phuc|xa ninh phuc
ninh phung|xa ninh phung
ninh phuoc|xa ninh phuoc
ninh phu|xa ninh phu
ninh quang|xa ninh quang
ninh quoi a|xa ninh quoi a
ninh quoi|xa ninh quoi
ninh sim|xa ninh sim
ninh son|phuong ninh son
ninh son|xa ninh son
ninh so|xa ninh so
ninh tan|xa ninh tan
ninh tay|xa ninh tay
ninh thang|xa ninh thang
ninh thanh loi a|xa ninh thanh loi a
ninh thanh loi|xa ninh thanh loi
ninh thanh|phuong ninh thanh
ninh than|xa ninh than
ninh thoi|xa ninh thoi
ninh tho|xa ninh tho
ninh thuong|xa ninh thuong
ninh thuy|phuong ninh thuy
ninh tien|xa ninh tien
ninh trung|xa ninh trung
ninh van|xa ninh van
ninh xa|phuong ninh xa
ninh xa|xa ninh xa
ninh xuan|xa ninh xuan
noi due|xa noi due
noi hoang|xa noi hoang
noi thon|xa noi thon
nong cong|thi tran nong cong
nong ha|xa nong ha
nong thuong|xa nong thuong
nong tien|phuong nong tien
nong trang|phuong nong trang
nong truong viet lam|thi tran nong truong viet lam
nong truong|xa nong truong
nong u|xa nong u
noong bua|phuong noong bua
noong heo|xa noong heo
noong het|xa noong het
noong lay|xa noong lay
noong luong|xa noong luong
nt le ninh|thi tran nt le ninh
nt lien son|thi tran nt lien son
nt moc chau|thi tran nt moc chau
nt thai binh|thi tran nt thai binh
nt tran phu|thi tran nt tran phu
nt viet trung|thi tran nt viet trung
nua ngam|xa nua ngam
nui deo|thi tran nui deo
nui doi|thi tran nui doi
nui sam|phuong nui sam
nui sap|thi tran nui sap
nui thanh|thi tran nui thanh
nui to|xa nui to
nui tuong|xa nui tuong
nui voi|xa nui voi
nung nang|xa nung nang
nuoc hai|thi tran nuoc hai
nuong dam|xa nuong dam
o cho dua|phuong o cho dua
o lam|xa o lam
o long vy|xa o long vy
o quy ho|phuong o quy ho
oc eo|thi tran oc eo
on luong|xa on luong
ong dinh|xa ong dinh
p rao|thi tran p rao
pa cheo|xa pa cheo
pa co|xa pa co
pa ham|xa pa ham
pa hu|xa pa hu
pa khoang|xa pa khoang
pa khoa|xa pa khoa
pa lau|xa pa lau
pa long|xa pa long
pa ma pha khinh|xa pa ma pha khinh
pa my|xa pa my
pa tan|xa pa tan
pa thom|xa pa thom
pa u|xa pa u
pa vay su|xa pa vay su
pa ve su|xa pa ve su
pa vi|xa pa vi
pac miau|thi tran pac miau
pac nga|xa pac nga
pac ta|xa pac ta
pai lung|xa pai lung
pha danh|xa pha danh
pha lai|phuong pha lai
pha le|xa pha le
pha long|xa pha long
pha mu|xa pha mu
pham dinh ho|phuong pham dinh ho
pham kha|xa pham kha
pham ngu lao|phuong pham ngu lao
pham ngu lao|xa pham ngu lao
pham thai|phuong pham thai
pham tran|xa pham tran
pham van coi|xa pham van coi
pham van hai|xa pham van hai
phan boi chau|phuong phan boi chau
phan chu trinh|phuong phan chu trinh
phan dien|xa phan dien
phan dinh phung|phuong phan dinh phung
phan dung|xa phan dung
phan hiep|xa phan hiep
phan hoa|xa phan hoa
phan lam|xa phan lam
phan me|xa phan me
phan ri cua|thi tran phan ri cua
phan ri thanh|xa phan ri thanh
phan sao nam|xa phan sao nam
phan si pang|phuong phan si pang
phan son|xa phan son
phan thanh|xa phan thanh
phan thiet|phuong phan thiet
phan tien|xa phan tien
phang so lin|xa phang so lin
phao dai|phuong phao dai
phat diem|thi tran phat diem
phat tich|xa phat tich
phi dien|xa phi dien
phi hai|xa phi hai
phi lieng|xa phi lieng
phi nhu|xa phi nhu
phi thong|xa phi thong
phi to|xa phi to
phieng ban|xa phieng ban
phieng cam|xa phieng cam
phieng con|xa phieng con
phieng khoai|xa phieng khoai
phieng luong|xa phieng luong
phieng pan|xa phieng pan
phin ho|xa phin ho
phin ngan|xa phin ngan
phinh giang|xa phinh giang
phinh ho|xa phinh ho
phinh sang|xa phinh sang
pho an|xa pho an
pho bang|thi tran pho bang
pho cao|xa pho cao
pho chau|thi tran pho chau
pho chau|xa pho chau
pho co|phuong pho co
pho cuong|xa pho cuong
pho hoa|phuong pho hoa
pho hue|phuong pho hue
pho khanh|xa pho khanh
pho la|xa pho la
pho lu|thi tran pho lu
pho minh|phuong pho minh
pho moi|thi tran pho moi
pho nhon|xa pho nhon
pho ninh|phuong pho ninh
pho phong|xa pho phong
pho quang|phuong pho quang
pho rang|thi tran pho rang
pho thanh|phuong pho thanh
pho thuan|xa pho thuan
pho van|phuong pho van
pho vinh|phuong pho vinh
phon xuong|thi tran phon xuong
phong an|xa phong an
phong binh|xa phong binh
phong chau|phuong phong chau
phong chau|thi tran phong chau
phong chau|xa phong chau
phong chuong|xa phong chuong
phong coc|phuong phong coc
phong dien|thi tran phong dien
phong dien|xa phong dien
phong dong|xa phong dong
phong du ha|xa phong du ha
phong du thuong|xa phong du thuong
phong du|xa phong du
phong hai|phuong phong hai
phong hai|xa phong hai
phong hien|xa phong hien
phong hoa|xa phong hoa
phong khe|phuong phong khe
phong lac|xa phong lac
phong lai|xa phong lai
phong lang|xa phong lang
phong lap|xa phong lap
phong loc|xa phong loc
phong minh|xa phong minh
phong my|xa phong my
phong nam|xa phong nam
phong nha|thi tran phong nha
phong nien|xa phong nien
phong phu|xa phong phu
phong quang|xa phong quang
phong son|thi tran phong son
phong son|xa phong son
phong tan|xa phong tan
phong thanh a|xa phong thanh a
phong thanh dong|xa phong thanh dong
phong thanh tay a|xa phong thanh tay a
phong thanh tay b|xa phong thanh tay b
phong thanh tay|xa phong thanh tay
phong thanh|xa phong thanh
phong thinh|xa phong thinh
phong tho|thi tran phong tho
phong thuy|xa phong thuy
phong thu|xa phong thu
phong van|xa phong van
phong xuan|xa phong xuan
phu an hoa|xa phu an hoa
phu an|xa phu an
phu bai|phuong phu bai
phu binh|phuong phu binh
phu binh|xa phu binh
phu can|xa phu can
phu cat|phuong phu cat
phu cat|xa phu cat
phu chanh|phuong phu chanh
phu chan|xa phu chan
phu chau|xa phu chau
phu cuong|phuong phu cuong
phu cuong|xa phu cuong
phu da|thi tran phu da
phu da|xa phu da
phu dien|phuong phu dien
phu dien|xa phu dien
phu dinh|xa phu dinh
phu dong|phuong phu dong
phu dong|xa phu dong
phu do|phuong phu do
phu do|xa phu do
phu duc|phuong phu duc
phu duc|xa phu duc
phu duong|xa phu duong
phu gia|xa phu gia
phu hai|phuong phu hai
phu hai|xa phu hai
phu hau|phuong phu hau
phu ha|phuong phu ha
phu hiep|phuong phu hiep
phu hiep|xa phu hiep
phu hoa dong|xa phu hoa dong
phu hoa|phuong phu hoa
phu hoa|thi tran phu hoa
phu hoa|xa phu hoa
phu hoi|phuong phu hoi
phu hoi|xa phu hoi
phu ho|xa phu ho
phu hung|xa phu hung
phu huu|phuong phu huu
phu huu|xa phu huu
phu khanh|phuong phu khanh
phu khanh|xa phu khanh
phu khe|xa phu khe
phu khuong|phuong phu khuong
phu kiet|xa phu kiet
phu kim|xa phu kim
phu lac|xa phu lac
phu lai|xa phu lai
phu lam|phuong phu lam
phu lam|xa phu lam
phu lang|xa phu lang
phu lap|xa phu lap
phu la|phuong phu la
phu le|xa phu le
phu lien|phuong phu lien
phu linh|xa phu linh
phu loc|thi tran phu loc
phu loc|xa phu loc
phu loi|phuong phu loi
phu loi|xa phu loi
phu long|thi tran phu long
phu long|xa phu long
phu lo|xa phu lo
phu lung|xa phu lung
phu luong|phuong phu luong
phu luong|xa phu luong
phu luu te|xa phu luu te
phu luu|xa phu luu
phu ly|xa phu ly
phu man|xa phu man
phu mau|xa phu mau
phu minh|thi tran phu minh
phu minh|xa phu minh
phu mo|xa phu mo
phu my hung|xa phu my hung
phu my|phuong phu my
phu my|thi tran phu my
phu my|xa phu my
phu nam an|xa phu nam an
phu nam|xa phu nam
phu ngai tri|xa phu ngai tri
phu nghia|xa phu nghia
phu nghiem|xa phu nghiem
phu ngoc|xa phu ngoc
phu nham|xa phu nham
phu nhuan|phuong phu nhuan
phu nhuan|xa phu nhuan
phu ninh|xa phu ninh
phu phong|thi tran phu phong
phu phong|xa phu phong
phu phuc|xa phu phuc
phu phung|xa phu phung
phu phuong|xa phu phuong
phu quoi|xa phu quoi
phu quy|xa phu quy
phu rieng|xa phu rieng
phu son|phuong phu son
phu son|xa phu son
phu tai|phuong phu tai
phu tam|xa phu tam
phu tan|phuong phu tan
phu tan|xa phu tan
phu thai|thi tran phu thai
phu thanh a|xa phu thanh a
phu thanh b|xa phu thanh b
phu thanh|phuong phu thanh
phu thanh|xa phu thanh
phu thien|thi tran phu thien
phu thinh|phuong phu thinh
phu thinh|thi tran phu thinh
phu thinh|xa phu thinh
phu thi|xa phu thi
phu tho hoa|phuong phu tho hoa
phu thong|thi tran phu thong
phu tho|phuong phu tho
phu tho|xa phu tho
phu thuan a|xa phu thuan a
phu thuan b|xa phu thuan b
phu thuan|phuong phu thuan
phu thuan|xa phu thuan
phu thuong|phuong phu thuong
phu thuong|xa phu thuong
phu thuy|phuong phu thuy
phu thuy|xa phu thuy
phu thu|phuong phu thu
phu thu|thi tran phu thu
phu tien|xa phu tien
phu trinh|phuong phu trinh
phu trung|phuong phu trung
phu trung|xa phu trung
phu tuc|thi tran phu tuc
phu tuc|xa phu tuc
phu ung|xa phu ung
phu vang|xa phu vang
phu van|xa phu van
phu vinh|xa phu vinh
phu xa|phuong phu xa
phu xa|xa phu xa
phu xuan|xa phu xuan
phu xuyen|thi tran phu xuyen
phu xuyen|xa phu xuyen
phu yen|thi tran phu yen
phu yen|xa phu yen
phuc an|xa phuc an
phuc chu|xa phuc chu
phuc dien|phuong phuc dien
phuc dong|phuong phuc dong
phuc dong|xa phuc dong
phuc ha|xa phuc ha
phuc hoa|xa phuc hoa
phuc khanh|xa phuc khanh
phuc khoa|xa phuc khoa
phuc lai|xa phuc lai
phuc lam|xa phuc lam
phuc la|phuong phuc la
phuc le|xa phuc le
phuc linh|xa phuc linh
phuc loc|xa phuc loc
phuc loi|phuong phuc loi
phuc loi|xa phuc loi
phuc luong|xa phuc luong
phuc ninh|xa phuc ninh
phuc sen|xa phuc sen
phuc son|xa phuc son
phuc tan|phuong phuc tan
phuc tan|xa phuc tan
phuc thang|phuong phuc thang
phuc thang|xa phuc thang
phuc thanh a|xa phuc thanh a
phuc thanh|phuong phuc thanh
phuc thanh|xa phuc thanh
phuc than|xa phuc than
phuc thinh|xa phuc thinh
phuc tho|thi tran phuc tho
phuc tho|xa phuc tho
phuc thuan|xa phuc thuan
phuc tien|xa phuc tien
phuc trach|xa phuc trach
phuc triu|xa phuc triu
phuc ung|xa phuc ung
phuc xa|phuong phuc xa
phuc xuan|xa phuc xuan
phuc yen|xa phuc yen
phung chau|xa phung chau
phung chi kien|phuong phung chi kien
phung cong|xa phung cong
phung giao|xa phung giao
phung hiep|xa phung hiep
phung hung|xa phung hung
phung minh|xa phung minh
phung nguyen|xa phung nguyen
phung thuong|xa phung thuong
phung xa|xa phung xa
phuoc an|thi tran phuoc an
phuoc an|xa phuoc an
phuoc binh|phuong phuoc binh
phuoc binh|xa phuoc binh
phuoc buu|thi tran phuoc buu
phuoc cat 2|xa phuoc cat 2
phuoc cat|thi tran phuoc cat
phuoc chanh|xa phuoc chanh
phuoc chien|xa phuoc chien
phuoc chinh|xa phuoc chinh
phuoc chi|xa phuoc chi
phuoc cong|xa phuoc cong
phuoc dai|xa phuoc dai
phuoc dan|thi tran phuoc dan
phuoc diem|xa phuoc diem
phuoc dinh|xa phuoc dinh
phuoc dong|xa phuoc dong
phuoc duc|xa phuoc duc
phuoc gia|xa phuoc gia
phuoc hai|phuong phuoc hai
phuoc hai|thi tran phuoc hai
phuoc hai|xa phuoc hai
phuoc hao|xa phuoc hao
phuoc hau|xa phuoc hau
phuoc ha|xa phuoc ha
phuoc hiep|phuong phuoc hiep
phuoc hiep|xa phuoc hiep
phuoc hoa|phuong phuoc hoa
phuoc hoa|xa phuoc hoa
phuoc hoi|phuong phuoc hoi
phuoc hoi|xa phuoc hoi
phuoc hung|phuong phuoc hung
phuoc hung|xa phuoc hung
phuoc huu|xa phuoc huu
phuoc khang|xa phuoc khang
phuoc khanh|xa phuoc khanh
phuoc kien|xa phuoc kien
phuoc kim|xa phuoc kim
phuoc lai|xa phuoc lai
phuoc lam|xa phuoc lam
phuoc lap|xa phuoc lap
phuoc loc|phuong phuoc loc
phuoc loc|xa phuoc loc
phuoc loi|xa phuoc loi
phuoc long a|phuong phuoc long a
phuoc long b|phuong phuoc long b
phuoc long tho|xa phuoc long tho
phuoc long|phuong phuoc long
phuoc long|thi tran phuoc long
phuoc long|xa phuoc long
phuoc ly|xa phuoc ly
phuoc minh|xa phuoc minh
phuoc my trung|xa phuoc my trung
phuoc my|phuong phuoc my
phuoc my|xa phuoc my
phuoc nam|xa phuoc nam
phuoc nang|xa phuoc nang
phuoc ngai|xa phuoc ngai
phuoc nghia|xa phuoc nghia
phuoc nguyen|phuong phuoc nguyen
phuoc ninh|phuong phuoc ninh
phuoc ninh|xa phuoc ninh
phuoc quang|xa phuoc quang
phuoc sang|xa phuoc sang
phuoc son|xa phuoc son
phuoc tan hung|xa phuoc tan hung
phuoc tan|phuong phuoc tan
phuoc tan|xa phuoc tan
phuoc thai|xa phuoc thai
phuoc thang|xa phuoc thang
phuoc thanh|xa phuoc thanh
phuoc the|xa phuoc the
phuoc thien|xa phuoc thien
phuoc thoi|phuong phuoc thoi
phuoc thuan|xa phuoc thuan
phuoc tien|phuong phuoc tien
phuoc tien|xa phuoc tien
phuoc tinh|xa phuoc tinh
phuoc tin|xa phuoc tin
phuoc trach|xa phuoc trach
phuoc tra|xa phuoc tra
phuoc trung|phuong phuoc trung
phuoc trung|xa phuoc trung
phuoc tuy|xa phuoc tuy
phuoc van|xa phuoc van
phuoc vinh an|xa phuoc vinh an
phuoc vinh dong|xa phuoc vinh dong
phuoc vinh tay|xa phuoc vinh tay
phuoc vinh|phuong phuoc vinh
phuoc vinh|thi tran phuoc vinh
phuoc vinh|xa phuoc vinh
phuoc xuan|xa phuoc xuan
phuong 1
phuong 10
phuong 11
phuong 12
phuong 13
phuong 14
phuong 15
phuong 16
phuong 17
phuong 18
phuong 19
phuong 2
phuong 21
phuong 22
phuong 24
phuong 25
phuong 26
phuong 27
phuong 28
phuong 3
phuong 4
phuong 5
phuong 6
phuong 7
phuong 8
phuong 9
phuong b'lao|blao
phuong binh|xa phuong binh
phuong buoi
phuong cach|xa phuong cach
phuong canh|phuong phuong canh
phuong chieu|xa phuong chieu
phuong cong|xa phuong cong
phuong dinh|xa phuong dinh
phuong dong|phuong phuong dong
phuong do|xa phuong do
phuong duc|phuong phuong duc
phuong duc|xa phuong duc
phuong giao|xa phuong giao
phuong hai|xa phuong hai
phuong ham rong|xa phuong ham rong
phuong i
phuong iii
phuong iv
phuong khoan|xa phuong khoan
phuong ky|xa phuong ky
phuong lam|phuong phuong lam
phuong lau|xa phuong lau
phuong lien|phuong phuong lien
phuong liet|phuong phuong liet
phuong lieu|xa phuong lieu
phuong mai|phuong phuong mai
phuong mao|xa phuong mao
phuong nam|phuong phuong nam
phuong nghi|xa phuong nghi
phuong phu|xa phuong phu
phuong sai|phuong phuong sai
phuong son|phuong phuong son
phuong son|xa phuong son
phuong thanh|xa phuong thanh
phuong thien|xa phuong thien
phuong thinh|xa phuong thinh
phuong tien|xa phuong tien
phuong tra|xa phuong tra
phuong trung|xa phuong trung
phuong tu|xa phuong tu
phuong v
phuong vien|xa phuong vien
phuong vii
phuong vi|xa phuong vi
pi toong|xa pi toong
plei kan|thi tran plei kan
po e|xa po e
po ko|xa po ko
po lo|xa po lo
po ly ngai|xa po ly ngai
po to|xa po to
pom han|phuong pom han
pom lot|xa pom lot
pong drang|xa pong drang
pu dao|xa pu dao
pu hong|xa pu hong
pu nhi|xa pu nhi
pu nhung|xa pu nhung
pu pau|xa pu pau
pu sam cap|xa pu sam cap
pu trang|phuong pu trang
pu xi|xa pu xi
pung banh|xa pung banh
pung luong|xa pung luong
pung tra|xa pung tra
quach pham bac|xa quach pham bac
quach pham|xa quach pham
quai cang|xa quai cang
quai nua|xa quai nua
quai to|xa quai to
quan bau|phuong quan bau
quan ba|xa quan ba
quan chu|thi tran quan chu
quan chu|xa quan chu
quan hanh|thi tran quan hanh
quan hau|thi tran quan hau
quan ha|xa quan ha
quan ho than|xa quan ho than
quan hoa|phuong quan hoa
quan lan|xa quan lan
quan lao|thi tran quan lao
quan son|xa quan son
quan thanh|phuong quan thanh
quan toan|phuong quan toan
quan trieu|phuong quan trieu
quan tru|phuong quan tru
quang an|phuong quang an
quang an|xa quang an
quang bach|xa quang bach
quang binh|xa quang binh
quang bi|xa quang bi
quang cat|xa quang cat
quang chau|phuong quang chau
quang chau|xa quang chau
quang chieu|xa quang chieu
quang chinh|xa quang chinh
quang chu|xa quang chu
quang cong|xa quang cong
quang cu|phuong quang cu
quang dai|xa quang dai
quang diem|xa quang diem
quang dien|xa quang dien
quang dinh|xa quang dinh
quang dong|xa quang dong
quang duc|xa quang duc
quang giao|xa quang giao
quang hai|xa quang hai
quang hanh|phuong quang hanh
quang han|xa quang han
quang ha|thi tran quang ha
quang hiep|xa quang hiep
quang hoa|xa quang hoa
quang hop|xa quang hop
quang huc|xa quang huc
quang hung|phuong quang hung
quang hung|xa quang hung
quang huy|xa quang huy
quang khai|xa quang khai
quang khe|xa quang khe
quang kim|xa quang kim
quang lac|xa quang lac
quang lam|xa quang lam
quang lang|xa quang lang
quang lap|xa quang lap
quang la|xa quang la
quang lich|xa quang lich
quang loc|xa quang loc
quang loi|xa quang loi
quang long|phuong quang long
quang long|xa quang long
quang luu|xa quang luu
quang minh|thi tran quang minh
quang minh|xa quang minh
quang ngai|xa quang ngai
quang ngan|xa quang ngan
quang nghia|xa quang nghia
quang nghiep|xa quang nghiep
quang ngoc|xa quang ngoc
quang nguyen|xa quang nguyen
quang nham|xa quang nham
quang nhan|xa quang nhan
quang ninh|xa quang ninh
quang phong|phuong quang phong
quang phong|xa quang phong
quang phu cau|xa quang phu cau
quang phuc|phuong quang phuc
quang phuc|xa quang phuc
quang phuoc|xa quang phuoc
quang phuong|xa quang phuong
quang phu|phuong quang phu
quang phu|thi tran quang phu
quang phu|xa quang phu
quang son|xa quang son
quang tam|xa quang tam
quang tan|xa quang tan
quang thach|xa quang thach
quang thai|xa quang thai
quang thang|phuong quang thang
quang thanh|phuong quang thanh
quang thanh|xa quang thanh
quang thien|xa quang thien
quang thinh|xa quang thinh
quang tho|phuong quang tho
quang tho|xa quang tho
quang thuan|phuong quang thuan
quang thuan|xa quang thuan
quang thuy|xa quang thuy
quang tien|phuong quang tien
quang tien|xa quang tien
quang tin|xa quang tin
quang trach|xa quang trach
quang tri|xa quang tri
quang trong|xa quang trong
quang truc|xa quang truc
quang trung|phuong quang trung
quang trung|xa quang trung
quang truong|xa quang truong
quang tung|xa quang tung
quang uyen|thi tran quang uyen
quang van|xa quang van
quang vinh|phuong quang vinh
quang vinh|xa quang vinh
quang xuan|xa quang xuan
quang yen|phuong quang yen
quang yen|xa quang yen
quat dong|xa quat dong
quat lam|thi tran quat lam
quat luu|xa quat luu
que an|xa que an
que chau|xa que chau
que hiep|xa que hiep
que lam|xa que lam
que loc|xa que loc
que long|xa que long
que luu|xa que luu
que minh|xa que minh
que my thanh|xa que my thanh
que my|xa que my
que nham|xa que nham
que phong|xa que phong
que phu|xa que phu
que tan|xa que tan
que tho|xa que tho
que thuan|xa que thuan
que trung|xa que trung
que xuan 1|xa que xuan 1
que xuan 2|xa que xuan 2
qui huong|xa qui huong
qui loc|xa qui loc
qui quan|xa qui quan
quoc khanh|xa quoc khanh
quoc oai|thi tran quoc oai
quoc oai|xa quoc oai
quoc thai|xa quoc thai
quoc toan|xa quoc toan
quoc tu giam|phuong quoc tu giam
quoc tuan|xa quoc tuan
quoc viet|xa quoc viet
quoi an|xa quoi an
quoi dien|xa quoi dien
quoi son|xa quoi son
quoi thanh|xa quoi thanh
quoi thien|xa quoi thien
quon long|xa quon long
quy dat|thi tran quy dat
quy duc|xa quy duc
quy hoa|xa quy hoa
quy hop|thi tran quy hop
quy ky|xa quy ky
quy mong|xa quy mong
quy nhat|thi tran quy nhat
quy quan|xa quy quan
quy son|xa quy son
quyet chien|xa quyet chien
quyet tam|phuong quyet tam
quyet thang|phuong quyet thang
quyet thang|xa quyet thang
quyet tien|phuong quyet tien
quyet tien|xa quyet tien
quynh bang|xa quynh bang
quynh bao|xa quynh bao
quynh ba|xa quynh ba
quynh chau|xa quynh chau
quynh coi|thi tran quynh coi
quynh dien|xa quynh dien
quynh di|phuong quynh di
quynh doi|xa quynh doi
quynh giang|xa quynh giang
quynh giao|xa quynh giao
quynh hai|xa quynh hai
quynh hau|xa quynh hau
quynh hoang|xa quynh hoang
quynh hoa|xa quynh hoa
quynh hoi|xa quynh hoi
quynh hong|xa quynh hong
quynh hung|xa quynh hung
quynh khe|xa quynh khe
quynh lam|xa quynh lam
quynh lap|xa quynh lap
quynh lien|xa quynh lien
quynh loc|xa quynh loc
quynh loi|phuong quynh loi
quynh long|xa quynh long
quynh luong|xa quynh luong
quynh luu|xa quynh luu
quynh mai|phuong quynh mai
quynh minh|xa quynh minh
quynh my|xa quynh my
quynh nghia|xa quynh nghia
quynh ngoc|xa quynh ngoc
quynh nguyen|xa quynh nguyen
quynh phuong|phuong quynh phuong
quynh phu|xa quynh phu
quynh son|xa quynh son
quynh tam|xa quynh tam
quynh tan|xa quynh tan
quynh thach|xa quynh thach
quynh thang|xa quynh thang
quynh thanh|xa quynh thanh
quynh thien|phuong quynh thien
quynh tho|xa quynh tho
quynh thuan|xa quynh thuan
quynh trang|xa quynh trang
quynh van|xa quynh van
quynh vinh|xa quynh vinh
quynh xa|xa quynh xa
quynh xuan|phuong quynh xuan
quynh yen|xa quynh yen
rach cheo|xa rach cheo
rach dua|phuong rach dua
rach goc|thi tran rach goc
rach goi|thi tran rach goi
rach soi|phuong rach soi
rang dong|thi tran rang dong
rang dong|xa rang dong
ro koi|xa ro koi
ro men|xa ro men
rung thong|thi tran rung thong
sa binh|xa sa binh
sa de phin|xa sa de phin
sa long|xa sa long
sa loong|xa sa loong
sa nghia|xa sa nghia
sa nhon|xa sa nhon
sa pa|phuong sa pa
sa rai|thi tran sa rai
sa son|xa sa son
sa thay|thi tran sa thay
sai dong|phuong sai dong
sai son|xa sai son
sam kha|xa sam kha
sam khoe|xa sam khoe
sam mun|xa sam mun
san chai|xa san chai
san thang|xa san thang
san vien|xa san vien
san xa ho|xa san xa ho
sang ma sao|xa sang ma sao
sang moc|xa sang moc
sang nhe|xa sang nhe
sang tung|xa sang tung
sao bay|xa sao bay
sao do|phuong sao do
sao vang|thi tran sao vang
sap vat|xa sap vat
sap xa|xa sap xa
sen phuong|xa sen phuong
sen thuong|xa sen thuong
sen thuy|xa sen thuy
si binh|xa si binh
si lo lau|xa si lo lau
si ma cai|thi tran si ma cai
si pa phin|xa si pa phin
sin cheng|xa sin cheng
sin ho|thi tran sin ho
sin suoi ho|xa sin suoi ho
sin thau|xa sin thau
sinh long|xa sinh long
sinh lung|xa sinh lung
sinh phinh|xa sinh phinh
sinh ton|xa sinh ton
so dau|phuong so dau
so pai|xa so pai
soc dang|xa soc dang
soc ha|xa soc ha
soc son|thi tran soc son
son a|xa son a
son bang|xa son bang
son bao|xa son bao
son ba|xa son ba
son binh|xa son binh
son bua|xa son bua
son cam|xa son cam
son cao|xa son cao
son chau|xa son chau
son cong|xa son cong
son cuong|xa son cuong
son da|xa son da
son dien|xa son dien
son dinh|xa son dinh
son dong|xa son dong
son dung|xa son dung
son duong|thi tran son duong
son duong|xa son duong
son giang|phuong son giang
son giang|xa son giang
son hai|xa son hai
son ham|xa son ham
son ha|xa son ha
son hiep|xa son hiep
son hoa|xa son hoa
son hoi|xa son hoi
son hong|xa son hong
son hung|xa son hung
son kien|xa son kien
son kim 1|xa son kim 1
son kim 2|xa son kim 2
son ky|phuong son ky
son ky|xa son ky
son lai|xa son lai
son lam|xa son lam
son lang|xa son lang
son lap|xa son lap
son le|xa son le
son lien|xa son lien
son linh|xa son linh
son loc|phuong son loc
son loc|xa son loc
son loi|xa son loi
son long|xa son long
son lo|xa son lo
son luong|xa son luong
son lu|thi tran son lu
son mau|xa son mau
son mua|xa son mua
son my|xa son my
son nam|xa son nam
son nguyen|xa son nguyen
son nham|xa son nham
son ninh|xa son ninh
son phong|phuong son phong
son phuoc|xa son phuoc
son phu|xa son phu
son tan|xa son tan
son tay|xa son tay
son thai|xa son thai
son thanh dong|xa son thanh dong
son thanh tay|xa son thanh tay
son thanh|xa son thanh
son thinh|thi tran son thinh
son thuong|xa son thuong
son thuy|xa son thuy
son tien|xa son tien
son tinh|xa son tinh
son tra|xa son tra
son trung|xa son trung
son truong|xa son truong
son vien|xa son vien
son vi|xa son vi
son xuan|xa son xuan
song an|xa song an
song bang|phuong song bang
song binh|xa song binh
song bo|phuong song bo
song cau|phuong song cau
song cau|thi tran song cau
song cau|xa song cau
song da|phuong song da
song doc|thi tran song doc
song giang|xa song giang
song hien|phuong song hien
song hinh|xa song hinh
song ho|xa song ho
song khe|xa song khe
song khoai|xa song khoai
song khua|xa song khua
song kon|xa song kon
song lang|xa song lang
song lieu|xa song lieu
song loc|xa song loc
song lo|xa song lo
song luy|xa song luy
song mai|xa song mai
song ma|thi tran song ma
song nhan|xa song nhan
song pe|xa song pe
song phan|xa song phan
song phung|xa song phung
song phuong|xa song phuong
song phu|xa song phu
song ray|xa song ray
song thao|xa song thao
song thuan|xa song thuan
song trau|xa song trau
song tra|xa song tra
song tu tay|xa song tu tay
song van|xa song van
song ve|thi tran song ve
song xoai|xa song xoai
sop cop|xa sop cop
su ngoi|xa su ngoi
sung do|xa sung do
sung la|xa sung la
sung mang|xa sung mang
sung nhon|xa sung nhon
sung phai|xa sung phai
sung thai|xa sung thai
sung trai|xa sung trai
sung trang|xa sung trang
sung tra|xa sung tra
suoi bac|xa suoi bac
suoi bang|xa suoi bang
suoi bau|xa suoi bau
suoi bu|xa suoi bu
suoi cao|xa suoi cao
suoi cat|xa suoi cat
suoi day|xa suoi day
suoi da|xa suoi da
suoi giang|xa suoi giang
suoi hiep|xa suoi hiep
suoi hoa|phuong suoi hoa
suoi hoa|xa suoi hoa
suoi kiet|xa suoi kiet
suoi nghe|xa suoi nghe
suoi ngo|xa suoi ngo
suoi nho|xa suoi nho
suoi quyen|xa suoi quyen
suoi rao|xa suoi rao
suoi tan|xa suoi tan
suoi tien|xa suoi tien
suoi to|xa suoi to
suoi trai|xa suoi trai
suoi tre|phuong suoi tre
ta an khuong dong|xa ta an khuong dong
ta an khuong nam|xa ta an khuong nam
ta an khuong|xa ta an khuong
ta ba|xa ta ba
ta bhinh|xa ta bhinh
ta bu|xa ta bu
ta ca|xa ta ca
ta chai|xa ta chai
ta cu ty|xa ta cu ty
ta danh|xa ta danh
ta gia khau|xa ta gia khau
ta gia|xa ta gia
ta hine|xa ta hine
ta hoc|xa ta hoc
ta hua|xa ta hua
ta khoa|xa ta khoa
ta lai|xa ta lai
ta leng|xa ta leng
ta long|xa ta long
ta lung|thi tran ta lung
ta lung|xa ta lung
ta lu|xa ta lu
ta ma|xa ta ma
ta mit|xa ta mit
ta mung|xa ta mung
ta nang|xa ta nang
ta ngai cho|xa ta ngai cho
ta ngao|xa ta ngao
ta nhiu|xa ta nhiu
ta nung|xa ta nung
ta phin|xa ta phin
ta phoi|xa ta phoi
ta poo|xa ta poo
ta rut|xa ta rut
ta si lang|xa ta si lang
ta sin thang|xa ta sin thang
ta su choong|xa ta su choong
ta thang|xa ta thang
ta thanh oai|xa ta thanh oai
ta tong|xa ta tong
ta van chu|xa ta van chu
ta van|xa ta van
ta xa|xa ta xa
ta xua|xa ta xua
tac van|xa tac van
tai son|xa tai son
tai van|xa tai van
tam anh bac|xa tam anh bac
tam anh nam|xa tam anh nam
tam an|xa tam an
tam binh|phuong tam binh
tam binh|thi tran tam binh
tam binh|xa tam binh
tam bo|xa tam bo
tam chung|xa tam chung
tam cuong|xa tam cuong
tam dai|xa tam dai
tam dan|xa tam dan
tam dao|thi tran tam dao
tam da|xa tam da
tam dinh|xa tam dinh
tam di|xa tam di
tam dong|xa tam dong
tam duong|thi tran tam duong
tam giang dong|xa tam giang dong
tam giang tay|xa tam giang tay
tam giang|xa tam giang
tam gia|xa tam gia
tam hai|xa tam hai
tam hiep|phuong tam hiep
tam hiep|xa tam hiep
tam hoa|phuong tam hoa
tam hoa|xa tam hoa
tam hong|xa tam hong
tam hop|xa tam hop
tam hung|xa tam hung
tam kim|xa tam kim
tam ky|xa tam ky
tam lanh|xa tam lanh
tam lap|xa tam lap
tam loc|xa tam loc
tam lu|xa tam lu
tam my dong|xa tam my dong
tam my tay|xa tam my tay
tam ngai|xa tam ngai
tam nghia|xa tam nghia
tam ngoc|xa tam ngoc
tam phuc|xa tam phuc
tam phuoc|phuong tam phuoc
tam phuoc|xa tam phuoc
tam phu|phuong tam phu
tam phu|xa tam phu
tam quan bac|phuong tam quan bac
tam quan nam|phuong tam quan nam
tam quang|xa tam quang
tam quan|phuong tam quan
tam quan|xa tam quan
tam son|thi tran tam son
tam son|xa tam son
tam thai|xa tam thai
tam thang|xa tam thang
tam thanh|phuong tam thanh
tam thanh|xa tam thanh
tam thon hiep|xa tam thon hiep
tam thuan|phuong tam thuan
tam thuan|xa tam thuan
tam tien|xa tam tien
tam tra|xa tam tra
tam van|xa tam van
tam vinh|xa tam vinh
tam vu|thi tran tam vu
tam xa|xa tam xa
tam xuan ii|xa tam xuan ii
tam xuan i|xa tam xuan i
tan an hoi|xa tan an hoi
tan an luong|xa tan an luong
tan an tay|xa tan an tay
tan an thanh|xa tan an thanh
tan an|phuong tan an
tan an|thi tran tan an
tan an|xa tan an
tan bac|xa tan bac
tan bang|xa tan bang
tan bien|phuong tan bien
tan bien|thi tran tan bien
tan binh thanh|xa tan binh thanh
tan binh|phuong tan binh
tan binh|thi tran tan binh
tan binh|xa tan binh
tan buu|xa tan buu
tan canh|xa tan canh
tan chanh hiep|phuong tan chanh hiep
tan chanh|xa tan chanh
tan chau|thi tran tan chau
tan chau|xa tan chau
tan chinh|phuong tan chinh
tan chi|xa tan chi
tan cong chi|xa tan cong chi
tan cong sinh|xa tan cong sinh
tan cuong|xa tan cuong
tan dan|phuong tan dan
tan dan|xa tan dan
tan dien|xa tan dien
tan dinh|phuong tan dinh
tan dinh|xa tan dinh
tan doan|xa tan doan
tan dong hiep|phuong tan dong hiep
tan dong|phuong tan dong
tan dong|xa tan dong
tan duc|xa tan duc
tan duong|xa tan duong
tan duyet|xa tan duyet
tan giang|phuong tan giang
tan hai|xa tan hai
tan hanh|phuong tan hanh
tan hanh|xa tan hanh
tan hao|xa tan hao
tan ha|phuong tan ha
tan ha|xa tan ha
tan hiep a|xa tan hiep a
tan hiep b|xa tan hiep b
tan hiep|phuong tan hiep
tan hiep|thi tran tan hiep
tan hiep|xa tan hiep
tan ho co|xa tan ho co
tan hoa dong|xa tan hoa dong
tan hoa tay|xa tan hoa tay
tan hoa thanh|xa tan hoa thanh
tan hoa|phuong tan hoa
tan hoa|thi tran tan hoa
tan hoa|xa tan hoa
tan hoc|xa tan hoc
tan hoi dong|xa tan hoi dong
tan hoi trung|xa tan hoi trung
tan hoi|phuong tan hoi
tan hoi|xa tan hoi
tan hong|phuong tan hong
tan hong|xa tan hong
tan hop|xa tan hop
tan hue|xa tan hue
tan hung dong|xa tan hung dong
tan hung tay|xa tan hung tay
tan hung thuan|phuong tan hung thuan
tan hung|phuong tan hung
tan hung|thi tran tan hung
tan hung|xa tan hung
tan huong|xa tan huong
tan khai|thi tran tan khai
tan khang|xa tan khang
tan khanh dong|xa tan khanh dong
tan khanh hoa|xa tan khanh hoa
tan khanh trung|xa tan khanh trung
tan khanh|phuong tan khanh
tan khanh|xa tan khanh
tan kieng|phuong tan kieng
tan kien|xa tan kien
tan kieu|xa tan kieu
tan kim|xa tan kim
tan ky|thi tran tan ky
tan ky|xa tan ky
tan lac|thi tran tan lac
tan lac|xa tan lac
tan lam huong|xa tan lam huong
tan lam|xa tan lam
tan lang|xa tan lang
tan lan|xa tan lan
tan lap 1|xa tan lap 1
tan lap 2|xa tan lap 2
tan lap|phuong tan lap
tan lap|xa tan lap
tan le|xa tan le
tan lien|xa tan lien
tan lieu|xa tan lieu
tan linh|xa tan linh
tan loc bac|xa tan loc bac
tan loc dong|xa tan loc dong
tan loc|phuong tan loc
tan loc|xa tan loc
tan loi thanh|xa tan loi thanh
tan loi|phuong tan loi
tan loi|xa tan loi
tan long hoi|xa tan long hoi
tan long|phuong tan long
tan long|xa tan long
tan luoc|xa tan luoc
tan ly dong|xa tan ly dong
tan ly tay|xa tan ly tay
tan mai|phuong tan mai
tan minh|thi tran tan minh
tan minh|xa tan minh
tan moc|xa tan moc
tan my chanh|xa tan my chanh
tan my ha|xa tan my ha
tan my|xa tan my
tan nam|xa tan nam
tan ngai|phuong tan ngai
tan nghia|thi tran tan nghia
tan nghia|xa tan nghia
tan nguyen|xa tan nguyen
tan nhuan dong|xa tan nhuan dong
tan nhut|xa tan nhut
tan ninh|xa tan ninh
tan pheo|xa tan pheo
tan phong|phuong tan phong
tan phong|thi tran tan phong
tan phong|xa tan phong
tan phu dong|xa tan phu dong
tan phu tay|xa tan phu tay
tan phu thanh|xa tan phu thanh
tan phu trung|xa tan phu trung
tan phuc|xa tan phuc
tan phuoc hung|xa tan phuoc hung
tan phuoc khanh|phuong tan phuoc khanh
tan phuoc tay|xa tan phuoc tay
tan phuoc|phuong tan phuoc
tan phuoc|xa tan phuoc
tan phuong|xa tan phuong
tan phu|phuong tan phu
tan phu|thi tran tan phu
tan phu|xa tan phu
tan quang|phuong tan quang
tan quang|xa tan quang
tan quan|xa tan quan
tan quoi trung|xa tan quoi trung
tan quoi|thi tran tan quoi
tan quoi|xa tan quoi
tan quy dong|phuong tan quy dong
tan quy tay|xa tan quy tay
tan quy|phuong tan quy
tan soi|xa tan soi
tan son nhi|phuong tan son nhi
tan son|phuong tan son
tan son|thi tran tan son
tan son|xa tan son
tan tac|xa tan tac
tan tai|phuong tan tai
tan tao a|phuong tan tao a
tan tao|phuong tan tao
tan tap|xa tan tap
tan tay|xa tan tay
tan thach|xa tan thach
tan thai|xa tan thai
tan thang|xa tan thang
tan thanh a|xa tan thanh a
tan thanh binh|xa tan thanh binh
tan thanh b|xa tan thanh b
tan thanh dong|xa tan thanh dong
tan thanh tay|xa tan thanh tay
tan thanh|phuong tan thanh
tan thanh|thi tran tan thanh
tan thanh|xa tan thanh
tan thieng|xa tan thieng
tan thien|phuong tan thien
tan thinh|phuong tan thinh
tan thinh|xa tan thinh
tan thoi hiep|phuong tan thoi hiep
tan thoi hoa|phuong tan thoi hoa
tan thoi nhat|phuong tan thoi nhat
tan thoi nhi|xa tan thoi nhi
tan thoi|xa tan thoi
tan thong hoi|xa tan thong hoi
tan tho|xa tan tho
tan thuan binh|xa tan thuan binh
tan thuan dong|phuong tan thuan dong
tan thuan dong|xa tan thuan dong
tan thuan tay|phuong tan thuan tay
tan thuan tay|xa tan thuan tay
tan thuan|xa tan thuan
tan thuong|xa tan thuong
tan thuy|xa tan thuy
tan tien|phuong tan tien
tan tien|xa tan tien
tan trach|xa tan trach
tan trao|xa tan trao
tan trieu|xa tan trieu
tan trinh|xa tan trinh
tan tri|xa tan tri
tan trung|xa tan trung
tan truong|xa tan truong
tan tru|thi tran tan tru
tan tuc|thi tran tan tuc
tan tuyen|xa tan tuyen
tan tu|xa tan tu
tan uoc|xa tan uoc
tan uyen|thi tran tan uyen
tan van|phuong tan van
tan van|xa tan van
tan vien|xa tan vien
tan viet|xa tan viet
tan vinh hiep|phuong tan vinh hiep
tan vinh|xa tan vinh
tan xa|xa tan xa
tan xuan|phuong tan xuan
tan xuan|xa tan xuan
tan xuyen|phuong tan xuyen
tan yen|thi tran tan yen
tan yen|xa tan yen
tang bat ho|thi tran tang bat ho
tang hoa|xa tang hoa
tang loong|thi tran tang loong
tang nhon phu a|phuong tang nhon phu a
tang nhon phu b|phuong tang nhon phu b
tang thanh|xa tang thanh
tang tien|xa tang tien
tao duong van|xa tao duong van
tao son|xa tao son
tao xuyen|phuong tao xuyen
tap ngai|xa tap ngai
tap son|xa tap son
tat nga|xa tat nga
tat thang|xa tat thang
tay an|xa tay an
tay binh|xa tay binh
tay coc|xa tay coc
tay dang|thi tran tay dang
tay do|xa tay do
tay giang|xa tay giang
tay hieu|xa tay hieu
tay hoa|xa tay hoa
tay ho|xa tay ho
tay hung|xa tay hung
tay loc|phuong tay loc
tay luong|xa tay luong
tay mo|phuong tay mo
tay ninh|xa tay ninh
tay phong|xa tay phong
tay phu|xa tay phu
tay son|phuong tay son
tay son|thi tran tay son
tay son|xa tay son
tay thanh|phuong tay thanh
tay thanh|xa tay thanh
tay thuan|xa tay thuan
tay tien|xa tay tien
tay trach|xa tay trach
tay tuu|phuong tay tuu
tay vinh|xa tay vinh
tay xuan|xa tay xuan
tay yen a|xa tay yen a
tay yen tu|thi tran tay yen tu
tay yen|xa tay yen
te le|xa te le
te loi|xa te loi
te lo|xa te lo
te nong|xa te nong
te thang|xa te thang
te xang|xa te xang
tenh phong|xa tenh phong
thac ba|thi tran thac ba
thac gian|phuong thac gian
thac mo|phuong thac mo
thach ban|phuong thach ban
thach binh|xa thach binh
thach cam|xa thach cam
thach chau|xa thach chau
thach dai|xa thach dai
thach dan|xa thach dan
thach da|xa thach da
thach dinh|xa thach dinh
thach dong|xa thach dong
thach giam|thi tran thach giam
thach hai|xa thach hai
thach ha|thi tran thach ha
thach ha|xa thach ha
thach hoa|xa thach hoa
thach hoi|xa thach hoi
thach hung|xa thach hung
thach kenh|xa thach kenh
thach khe|xa thach khe
thach khoan|xa thach khoan
thach khoi|phuong thach khoi
thach kiet|xa thach kiet
thach kim|xa thach kim
thach lac|xa thach lac
thach lam|xa thach lam
thach lap|xa thach lap
thach lien|xa thach lien
thach linh|phuong thach linh
thach loi|xa thach loi
thach long|xa thach long
thach luong|xa thach luong
thach my|xa thach my
thach ngan|xa thach ngan
thach ngoc|xa thach ngoc
thach quang|xa thach quang
thach quy|phuong thach quy
thach son|xa thach son
thach thang|phuong thach thang
thach thang|xa thach thang
thach than|xa thach than
thach tri|xa thach tri
thach trung|xa thach trung
thach tuong|xa thach tuong
thach van|xa thach van
thach xa|xa thach xa
thach xuan|xa thach xuan
thach yen|xa thach yen
thai an|xa thai an
thai bao|xa thai bao
thai binh trung|xa thai binh trung
thai binh|phuong thai binh
thai binh|xa thai binh
thai cuong|xa thai cuong
thai dao|xa thai dao
thai do|xa thai do
thai duong|xa thai duong
thai giang pho|xa thai giang pho
thai giang|xa thai giang
thai hoa|phuong thai hoa
thai hoa|xa thai hoa
thai hoc|phuong thai hoc
thai hoc|xa thai hoc
thai hung|xa thai hung
thai long|xa thai long
thai my|xa thai my
thai nguyen|xa thai nguyen
thai nien|xa thai nien
thai phin tung|xa thai phin tung
thai phuc|xa thai phuc
thai phuong|xa thai phuong
thai son|xa thai son
thai tan|xa thai tan
thai thinh|phuong thai thinh
thai thinh|xa thai thinh
thai tho|xa thai tho
thai thuong|xa thai thuong
thai thuy|xa thai thuy
thai tri|xa thai tri
thai xuyen|xa thai xuyen
tham don|xa tham don
tham duong|xa tham duong
than cuu nghia|xa than cuu nghia
than thuoc|xa than thuoc
than uyen|thi tran than uyen
than xa|xa than xa
thang binh|xa thang binh
thang hai|xa thang hai
thang hung|xa thang hung
thang loi|phuong thang loi
thang loi|xa thang loi
thang long|xa thang long
thang mo|xa thang mo
thang nhat|phuong thang nhat
thang nhi|phuong thang nhi
thang phuoc|xa thang phuoc
thang quan|xa thang quan
thang son|xa thang son
thang tam|phuong thang tam
thang tho|xa thang tho
thang thuy|xa thang thuy
thang tin|xa thang tin
thanh an|thi tran thanh an
thanh an|xa thanh an
thanh bac|xa thanh bac
thanh ba|thi tran thanh ba
thanh binh thinh|xa thanh binh thinh
thanh binh|phuong thanh binh
thanh binh|thi tran thanh binh
thanh binh|xa thanh binh
thanh cao|xa thanh cao
thanh chan|xa thanh chan
thanh chau|phuong thanh chau
thanh chi|xa thanh chi
thanh chuong|thi tran thanh chuong
thanh cong|phuong thanh cong
thanh cong|xa thanh cong
thanh cuong|xa thanh cuong
thanh da|xa thanh da
thanh dien|xa thanh dien
thanh dinh|xa thanh dinh
thanh dong a|xa thanh dong a
thanh dong b|xa thanh dong b
thanh dong|xa thanh dong
thanh duc|xa thanh duc
thanh duong|xa thanh duong
thanh giang|xa thanh giang
thanh hai|phuong thanh hai
thanh hai|xa thanh hai
thanh ha|phuong thanh ha
thanh ha|thi tran thanh ha
thanh ha|xa thanh ha
thanh hoa son|xa thanh hoa son
thanh hoa|phuong thanh hoa
thanh hoa|thi tran thanh hoa
thanh hoa|xa thanh hoa
thanh hoi|xa thanh hoi
thanh hong|xa thanh hong
thanh hung|xa thanh hung
thanh huong|xa thanh huong
thanh khai|xa thanh khai
thanh khe dong|phuong thanh khe dong
thanh khe tay|phuong thanh khe tay
thanh khe|xa thanh khe
thanh khuong|xa thanh khuong
thanh ky|xa thanh ky
thanh lac|xa thanh lac
thanh lam|xa thanh lam
thanh lang|thi tran thanh lang
thanh lang|xa thanh lang
thanh lan|xa thanh lan
thanh lien|xa thanh lien
thanh liet|xa thanh liet
thanh linh|xa thanh linh
thanh loa|xa thanh loa
thanh loc|phuong thanh loc
thanh loc|xa thanh loc
thanh loi|xa thanh loi
thanh long|xa thanh long
thanh luan|xa thanh luan
thanh luong|phuong thanh luong
thanh luong|xa thanh luong
thanh mai|xa thanh mai
thanh mien|thi tran thanh mien
thanh mieu|phuong thanh mieu
thanh minh|xa thanh minh
thanh my loi|phuong thanh my loi
thanh my tay|xa thanh my tay
thanh my|thi tran thanh my
thanh my|xa thanh my
thanh ngai|xa thanh ngai
thanh nghi|xa thanh nghi
thanh ngoc|xa thanh ngoc
thanh nguyen|xa thanh nguyen
thanh nhan|phuong thanh nhan
thanh nhat|phuong thanh nhat
thanh nhat|thi tran thanh nhat
thanh nho|xa thanh nho
thanh nhut|xa thanh nhut
thanh ninh|xa thanh ninh
thanh nua|xa thanh nua
thanh phong|xa thanh phong
thanh phu dong|xa thanh phu dong
thanh phu long|xa thanh phu long
thanh phuoc|phuong thanh phuoc
thanh phuoc|xa thanh phuoc
thanh phu|thi tran thanh phu
thanh phu|xa thanh phu
thanh quang|xa thanh quang
thanh quan|xa thanh quan
thanh quoi|xa thanh quoi
thanh son|phuong thanh son
thanh son|thi tran thanh son
thanh son|xa thanh son
thanh tam|xa thanh tam
thanh tan|xa thanh tan
thanh tay|xa thanh tay
thanh thach|xa thanh thach
thanh thang|xa thanh thang
thanh thinh|xa thanh thinh
thanh thoi an|xa thanh thoi an
thanh thoi a|xa thanh thoi a
thanh thoi b|xa thanh thoi b
thanh thoi thuan|xa thanh thoi thuan
thanh tho|xa thanh tho
thanh thuy|thi tran thanh thuy
thanh thuy|xa thanh thuy
thanh tien|xa thanh tien
thanh to|phuong thanh to
thanh trach|xa thanh trach
thanh trieu|xa thanh trieu
thanh tri|phuong thanh tri
thanh tri|xa thanh tri
thanh truc|xa thanh truc
thanh trung|xa thanh trung
thanh truong|phuong thanh truong
thanh tru|xa thanh tru
thanh tung|xa thanh tung
thanh tuong|xa thanh tuong
thanh tuyen|phuong thanh tuyen
thanh tuyen|xa thanh tuyen
thanh uyen|xa thanh uyen
thanh van|xa thanh van
thanh vinh dong|xa thanh vinh dong
thanh vinh|phuong thanh vinh
thanh vinh|xa thanh vinh
thanh xa|xa thanh xa
thanh xuan bac|phuong thanh xuan bac
thanh xuan nam|phuong thanh xuan nam
thanh xuan trung|phuong thanh xuan trung
thanh xuan|phuong thanh xuan
thanh xuan|xa thanh xuan
thanh xuong|xa thanh xuong
thanh yen a|xa thanh yen a
thanh yen|xa thanh yen
thao chu phin|xa thao chu phin
thao dien|phuong thao dien
that hung|phuong that hung
that khe|thi tran that khe
the duc|xa the duc
then chu phin|xa then chu phin
then phang|xa then phang
then sin|xa then sin
thi cau|phuong thi cau
thi hoa|xa thi hoa
thi nai|phuong thi nai
thi son|xa thi son
thi tran bo
thi tran cho
thi tran chu
thi tran con
thi tran d'ran|dran
thi tran du
thi tran goi
thi tran ho
thi tran kbang
thi tran kep
thi tran lam
thi tran lim
thi tran m'drak|mdrak
thi tran me
thi tran nenh
thi tran nghen
thi tran nua
thi tran phung
thi tran que
thi tran sia
thi tran thang
thi tran thua
thi tran voi
thi tran vuong
thien an|phuong thien an
thien cam|thi tran thien cam
thien hoa|xa thien hoa
thien hung|xa thien hung
thien huong|xa thien huong
thien ke|xa thien ke
thien loc|xa thien loc
thien long|xa thien long
thien my|xa thien my
thien nghiep|xa thien nghiep
thien phien|xa thien phien
thien phu|xa thien phu
thien tan|xa thien tan
thien thuat|xa thien thuat
thien ton|thi tran thien ton
thien tri|xa thien tri
thien trung|xa thien trung
thiet ke|xa thiet ke
thiet ong|xa thiet ong
thieu chinh|xa thieu chinh
thieu cong|xa thieu cong
thieu duong|xa thieu duong
thieu duy|xa thieu duy
thieu giang|xa thieu giang
thieu giao|xa thieu giao
thieu hoa|thi tran thieu hoa
thieu hoa|xa thieu hoa
thieu hop|xa thieu hop
thieu khanh|xa thieu khanh
thieu long|xa thieu long
thieu ly|xa thieu ly
thieu ngoc|xa thieu ngoc
thieu nguyen|xa thieu nguyen
thieu phuc|xa thieu phuc
thieu phu|xa thieu phu
thieu quang|xa thieu quang
thieu thanh|xa thieu thanh
thieu thinh|xa thieu thinh
thieu tien|xa thieu tien
thieu toan|xa thieu toan
thieu trung|xa thieu trung
thieu van|xa thieu van
thieu vien|xa thieu vien
thieu vu|xa thieu vu
thinh dan|phuong thinh dan
thinh duc|xa thinh duc
thinh hung|xa thinh hung
thinh lang|phuong thinh lang
thinh liet|phuong thinh liet
thinh loc|xa thinh loc
thinh long|thi tran thinh long
thinh minh|xa thinh minh
thinh quang|phuong thinh quang
thinh son|xa thinh son
thinh thanh|xa thinh thanh
thinh vuong|xa thinh vuong
tho an|xa tho an
tho binh|xa tho binh
tho chau|xa tho chau
tho cuong|xa tho cuong
tho dan|xa tho dan
tho dien|xa tho dien
tho hai|xa tho hai
tho hop|xa tho hop
tho lam|xa tho lam
tho lap|xa tho lap
tho loc|xa tho loc
tho nghiep|xa tho nghiep
tho ngoc|xa tho ngoc
tho phu|xa tho phu
tho quang|phuong tho quang
tho quan|phuong tho quan
tho son|phuong tho son
tho son|xa tho son
tho tang|thi tran tho tang
tho tan|xa tho tan
tho thanh|xa tho thanh
tho the|xa tho the
tho tien|xa tho tien
tho van|xa tho van
tho vinh|xa tho vinh
tho vuc|xa tho vuc
tho xuan|thi tran tho xuan
tho xuan|xa tho xuan
tho xuong|phuong tho xuong
tho xuong|xa tho xuong
thoai giang|xa thoai giang
thoi an dong|phuong thoi an dong
thoi an hoi|xa thoi an hoi
thoi an|phuong thoi an
thoi binh|phuong thoi binh
thoi binh|thi tran thoi binh
thoi binh|xa thoi binh
thoi dong|xa thoi dong
thoi hoa|phuong thoi hoa
thoi hoa|xa thoi hoa
thoi hung|xa thoi hung
thoi lai|thi tran thoi lai
thoi lai|xa thoi lai
thoi long|phuong thoi long
thoi quan|xa thoi quan
thoi son|xa thoi son
thoi tam thon|xa thoi tam thon
thoi tan|xa thoi tan
thoi thanh|xa thoi thanh
thoi thuan|phuong thoi thuan
thoi thuan|xa thoi thuan
thoi xuan|xa thoi xuan
thom mon|xa thom mon
thong binh|xa thong binh
thong hoa|xa thong hoa
thong kenh|xa thong kenh
thong nguyen|xa thong nguyen
thong nhat|phuong thong nhat
thong nhat|thi tran thong nhat
thong nhat|xa thong nhat
thong nong|thi tran thong nong
thong thu|xa thong thu
thot not|phuong thot not
thu ba|thi tran thu ba
thu cuc|xa thu cuc
thu lum|xa thu lum
thu muoi mot|thi tran thu muoi mot
thu ngac|xa thu ngac
thu phong|xa thu phong
thu phu|xa thu phu
thu sy|xa thu sy
thu ta|xa thu ta
thu thiem|phuong thu thiem
thu thua|thi tran thu thua
thu thuy|phuong thu thuy
thua duc|xa thua duc
thuan an|phuong thuan an
thuan an|thi tran thuan an
thuan an|xa thuan an
thuan binh|xa thuan binh
thuan chau|thi tran thuan chau
thuan dien|xa thuan dien
thuan duc|xa thuan duc
thuan giao|phuong thuan giao
thuan hanh|xa thuan hanh
thuan ha|xa thuan ha
thuan hoa|phuong thuan hoa
thuan hoa|xa thuan hoa
thuan hung|phuong thuan hung
thuan hung|xa thuan hung
thuan loc|phuong thuan loc
thuan loc|xa thuan loc
thuan loi|xa thuan loi
thuan mang|xa thuan mang
thuan minh|xa thuan minh
thuan my|xa thuan my
thuan nam|thi tran thuan nam
thuan nghia hoa|xa thuan nghia hoa
thuan phuoc|phuong thuan phuoc
thuan phu|xa thuan phu
thuan qui|xa thuan qui
thuan son|xa thuan son
thuan thanh|phuong thuan thanh
thuan thanh|xa thuan thanh
thuan thien|xa thuan thien
thuan thoi|xa thuan thoi
thuan yen|xa thuan yen
thuc khang|xa thuc khang
thuc luyen|xa thuc luyen
thung nai|xa thung nai
thuong am|xa thuong am
thuong an|xa thuong an
thuong bang la|xa thuong bang la
thuong binh|xa thuong binh
thuong cat|phuong thuong cat
thuong coc|xa thuong coc
thuong cuong|xa thuong cuong
thuong cuu|xa thuong cuu
thuong dinh|phuong thuong dinh
thuong dinh|xa thuong dinh
thuong giao|xa thuong giao
thuong giap|xa thuong giap
thuong ha|xa thuong ha
thuong hien|xa thuong hien
thuong hoa|xa thuong hoa
thuong kiem|xa thuong kiem
thuong lac|xa thuong lac
thuong lam|xa thuong lam
thuong lan|xa thuong lan
thuong loc|xa thuong loc
thuong long|xa thuong long
thuong lo|xa thuong lo
thuong ly|phuong thuong ly
thuong mo|xa thuong mo
thuong nga|xa thuong nga
thuong nhat|xa thuong nhat
thuong ninh|xa thuong ninh
thuong nong|xa thuong nong
thuong nung|xa thuong nung
thuong phung|xa thuong phung
thuong phuoc 1|xa thuong phuoc 1
thuong phuoc 2|xa thuong phuoc 2
thuong quang|xa thuong quang
thuong quan|xa thuong quan
thuong son|xa thuong son
thuong tan loc|xa thuong tan loc
thuong tan|xa thuong tan
thuong thang|xa thuong thang
thuong thanh|phuong thuong thanh
thuong thoi hau a|xa thuong thoi hau a
thuong thoi tien|thi tran thuong thoi tien
thuong thon|xa thuong thon
thuong tin|thi tran thuong tin
thuong trach|xa thuong trach
thuong trung|xa thuong trung
thuong vuc|xa thuong vuc
thuong vu|xa thuong vu
thuong xuan|thi tran thuong xuan
thuong yen cong|xa thuong yen cong
thuy an|xa thuy an
thuy bang|xa thuy bang
thuy bieu|phuong thuy bieu
thuy binh|xa thuy binh
thuy chau|phuong thuy chau
thuy chinh|xa thuy chinh
thuy dan|xa thuy dan
thuy dong|xa thuy dong
thuy duong|phuong thuy duong
thuy duong|xa thuy duong
thuy duyen|xa thuy duyen
thuy hai|xa thuy hai
thuy hoa|xa thuy hoa
thuy hung|xa thuy hung
thuy huong|xa thuy huong
thuy khue|phuong thuy khue
thuy lam|xa thuy lam
thuy lien|xa thuy lien
thuy lieu|xa thuy lieu
thuy loi|xa thuy loi
thuy luong|phuong thuy luong
thuy ninh|xa thuy ninh
thuy phong|xa thuy phong
thuy phuong|phuong thuy phuong
thuy phu|xa thuy phu
thuy quynh|xa thuy quynh
thuy son|xa thuy son
thuy tan|xa thuy tan
thuy tay|xa thuy tay
thuy thanh|xa thuy thanh
thuy trieu|xa thuy trieu
thuy trinh|xa thuy trinh
thuy truong|xa thuy truong
thuy van|xa thuy van
thuy viet|xa thuy viet
thuy xuan tien|xa thuy xuan tien
thuy xuan|phuong thuy xuan
thuy xuan|xa thuy xuan
tia dinh|xa tia dinh
tich giang|xa tich giang
tich luong|phuong tich luong
tich son|phuong tich son
tich thien|xa tich thien
tien an|phuong tien an
tien an|xa tien an
tien bo|xa tien bo
tien cam|xa tien cam
tien canh|xa tien canh
tien cat|phuong tien cat
tien chau|phuong tien chau
tien chau|xa tien chau
tien cuong|xa tien cuong
tien dien|thi tran tien dien
tien dong|xa tien dong
tien duc|xa tien duc
tien dung|xa tien dung
tien duoc|xa tien duoc
tien duong|xa tien duong
tien du|xa tien du
tien hai|thi tran tien hai
tien hai|xa tien hai
tien ha|xa tien ha
tien hiep|xa tien hiep
tien hoang|xa tien hoang
tien hoa|xa tien hoa
tien hoi|xa tien hoi
tien hung|xa tien hung
tien kien|xa tien kien
tien kieu|xa tien kieu
tien ky|thi tran tien ky
tien ky|xa tien ky
tien lang|thi tran tien lang
tien lang|xa tien lang
tien lanh|xa tien lanh
tien lap|xa tien lap
tien loc|xa tien loc
tien loi|xa tien loi
tien long|xa tien long
tien luc|xa tien luc
tien luong|xa tien luong
tien lu|xa tien lu
tien minh|xa tien minh
tien my|xa tien my
tien ngoai|xa tien ngoai
tien ngoc|xa tien ngoc
tien nguyen|xa tien nguyen
tien nha|xa tien nha
tien noi|phuong tien noi
tien nong|xa tien nong
tien phong|phuong tien phong
tien phong|xa tien phong
tien phuong|xa tien phuong
tien phu|xa tien phu
tien son|xa tien son
tien tan|xa tien tan
tien thang|xa tien thang
tien thanh|phuong tien thanh
tien thanh|xa tien thanh
tien thinh|xa tien thinh
tien tho|xa tien tho
tien thuan|xa tien thuan
tien thuy|xa tien thuy
tien tien|xa tien tien
tien trang|xa tien trang
tien xuan|xa tien xuan
tien yen|thi tran tien yen
tien yen|xa tien yen
tieu can|thi tran tieu can
tieu dong|xa tieu dong
tieu son|xa tieu son
tinh an dong|xa tinh an dong
tinh an tay|xa tinh an tay
tinh an|xa tinh an
tinh bac|xa tinh bac
tinh bien|thi tran tinh bien
tinh binh|xa tinh binh
tinh chau|xa tinh chau
tinh dong|xa tinh dong
tinh giang|xa tinh giang
tinh hai|phuong tinh hai
tinh ha|xa tinh ha
tinh hiep|xa tinh hiep
tinh hoa|xa tinh hoa
tinh khe|xa tinh khe
tinh ky|xa tinh ky
tinh long|xa tinh long
tinh minh|xa tinh minh
tinh nhue|xa tinh nhue
tinh phong|xa tinh phong
tinh son|xa tinh son
tinh thien|xa tinh thien
tinh thoi|xa tinh thoi
tinh tho|xa tinh tho
tinh tra|xa tinh tra
tinh tuc|thi tran tinh tuc
to chau|phuong to chau
to hap|thi tran to hap
to hieu|phuong to hieu
to hieu|xa to hieu
to mau|xa to mau
to mua|xa to mua
to tung|xa to tung
toa tinh|xa toa tinh
toan son|xa toan son
toan thang|xa toan thang
toc tien|xa toc tien
tong bat|xa tong bat
tong cot|xa tong cot
tong co|xa tong co
tong dau|xa tong dau
tong lanh|xa tong lanh
tong phan|xa tong phan
tong qua lin|xa tong qua lin
tong sanh|xa tong sanh
tong tran|xa tong tran
tot dong|xa tot dong
tra an|phuong tra an
tra ba|phuong tra ba
tra binh|xa tra binh
tra bui|xa tra bui
tra cang|xa tra cang
tra con|xa tra con
tra co|phuong tra co
tra co|xa tra co
tra cu|thi tran tra cu
tra da|xa tra da
tra doc|xa tra doc
tra dong|xa tra dong
tra don|xa tra don
tra duong|xa tra duong
tra giac|xa tra giac
tra giang|xa tra giang
tra giap|xa tra giap
tra hiep|xa tra hiep
tra ka|xa tra ka
tra kot|xa tra kot
tra lam|xa tra lam
tra leng|xa tra leng
tra linh|thi tran tra linh
tra linh|xa tra linh
tra long|phuong tra long
tra mai|xa tra mai
tra my|thi tran tra my
tra nam|xa tra nam
tra noc|phuong tra noc
tra nu|xa tra nu
tra on|thi tran tra on
tra phong|xa tra phong
tra phu|xa tra phu
tra son|xa tra son
tra tan|xa tra tan
tra tap|xa tra tap
tra tay|xa tra tay
tra thanh|xa tra thanh
tra thuy|xa tra thuy
tra van|xa tra van
tra vinh|xa tra vinh
tra vong|xa tra vong
tra xinh|xa tra xinh
tra xuan|thi tran tra xuan
trac van|xa trac van
trach my loc|xa trach my loc
trai cau|phuong trai cau
trai cau|thi tran trai cau
trai chuoi|phuong trai chuoi
tram chim|thi tran tram chim
tram hanh|xa tram hanh
tram long|xa tram long
tram lo|xa tram lo
tram tau|thi tran tram tau
tram tau|xa tram tau
tram than|xa tram than
tram troi|thi tran tram troi
tran cao|thi tran tran cao
tran chau|xa tran chau
tran dang ninh|phuong tran dang ninh
tran de|thi tran tran de
tran duong|xa tran duong
tran hoi|xa tran hoi
tran hung dao|phuong tran hung dao
tran hung dao|xa tran hung dao
tran lam|phuong tran lam
tran nguyen han|phuong tran nguyen han
tran ninh|xa tran ninh
tran phan|xa tran phan
tran phu|phuong tran phu
tran phu|xa tran phu
tran quang dieu|phuong tran quang dieu
tran quang khai|phuong tran quang khai
tran te xuong|phuong tran te xuong
tran thanh ngo|phuong tran thanh ngo
tran thoi|xa tran thoi
tran van thoi|thi tran tran van thoi
tran yen|xa tran yen
trang an|phuong trang an
trang an|xa trang an
trang bang|phuong trang bang
trang bom|thi tran trang bom
trang cac|xa trang cac
trang cat|phuong trang cat
trang dai|phuong trang dai
trang da|xa trang da
trang ha|phuong trang ha
trang luong|xa trang luong
trang minh|phuong trang minh
trang phai|xa trang phai
trang son|xa trang son
trang tien|phuong trang tien
trang viet|xa trang viet
trang xa|xa trang xa
trau quy|thi tran trau quy
tri an|xa tri an
tri binh|xa tri binh
tri hai|xa tri hai
tri le|xa tri le
tri luc|xa tri luc
tri nang|xa tri nang
tri phai|xa tri phai
tri phuong|xa tri phuong
tri phu|xa tri phu
tri quang|xa tri quang
tri quan|xa tri quan
tri qua|xa tri qua
tri thuy|xa tri thuy
tri ton|thi tran tri ton
tri trung|xa tri trung
tri yen|xa tri yen
trieu ai|xa trieu ai
trieu an|xa trieu an
trieu dai|xa trieu dai
trieu de|xa trieu de
trieu do|xa trieu do
trieu giang|xa trieu giang
trieu hai|xa trieu hai
trieu hoa|xa trieu hoa
trieu lang|xa trieu lang
trieu loc|xa trieu loc
trieu long|xa trieu long
trieu nguyen|xa trieu nguyen
trieu phuoc|xa trieu phuoc
trieu son|thi tran trieu son
trieu son|xa trieu son
trieu tai|xa trieu tai
trieu thanh|xa trieu thanh
trieu thuan|xa trieu thuan
trieu thuong|xa trieu thuong
trieu trach|xa trieu trach
trieu trung|xa trieu trung
trieu van|xa trieu van
trinh phu|xa trinh phu
trinh tuong|xa trinh tuong
trinh xa|xa trinh xa
trong con|xa trong con
trong hoa|xa trong hoa
trong quan|xa trong quan
tru huu|xa tru huu
tru son|xa tru son
tru van tho|xa tru van tho
truc bach|phuong truc bach
truc chinh|xa truc chinh
truc cuong|xa truc cuong
truc dai|xa truc dai
truc dao|xa truc dao
truc hung|xa truc hung
truc khang|xa truc khang
truc lam|phuong truc lam
truc lau|xa truc lau
truc my|xa truc my
truc noi|xa truc noi
truc son|xa truc son
truc thai|xa truc thai
truc thang|xa truc thang
truc thanh|xa truc thanh
truc thuan|xa truc thuan
truc tuan|xa truc tuan
trung an|xa trung an
trung binh|xa trung binh
trung chai|xa trung chai
trung chanh|xa trung chanh
trung chau|xa trung chau
trung chinh|xa trung chinh
trung dong|xa trung dong
trung do|phuong trung do
trung dung|phuong trung dung
trung dung|xa trung dung
trung giang|xa trung giang
trung giap|xa trung giap
trung gia|xa trung gia
trung hai|xa trung hai
trung ha|xa trung ha
trung hiep|xa trung hiep
trung hieu|xa trung hieu
trung hoa|phuong trung hoa
trung hoa|xa trung hoa
trung hoi|xa trung hoi
trung hung|phuong trung hung
trung hung|xa trung hung
trung kenh|xa trung kenh
trung khanh|thi tran trung khanh
trung khanh|xa trung khanh
trung kien|phuong trung kien
trung kien|xa trung kien
trung lap ha|xa trung lap ha
trung lap thuong|xa trung lap thuong
trung lap|xa trung lap
trung leng ho|xa trung leng ho
trung liet|phuong trung liet
trung loc|xa trung loc
trung luong|phuong trung luong
trung luong|xa trung luong
trung ly|xa trung ly
trung mau|xa trung mau
trung minh|xa trung minh
trung mon|xa trung mon
trung my tay|phuong trung my tay
trung my|xa trung my
trung nam|xa trung nam
trung ngai|xa trung ngai
trung nghia|xa trung nghia
trung nguyen|xa trung nguyen
trung nhi|phuong trung nhi
trung nhut|phuong trung nhut
trung phuc cuong|xa trung phuc cuong
trung phuc|xa trung phuc
trung phung|phuong trung phung
trung son tram|phuong trung son tram
trung son|phuong trung son
trung son|xa trung son
trung tam|phuong trung tam
trung tam|xa trung tam
trung thanh dong|xa trung thanh dong
trung thanh tay|xa trung thanh tay
trung thanh|phuong trung thanh
trung thanh|xa trung thanh
trung thinh|xa trung thinh
trung thuong|xa trung thuong
trung thu|xa trung thu
trung tien|xa trung tien
trung trach|xa trung trach
trung trac|phuong trung trac
trung trac|xa trung trac
trung truc|xa trung truc
trung tu|phuong trung tu
trung tu|xa trung tu
trung van|phuong trung van
trung vuong|phuong trung vuong
trung vuong|xa trung vuong
trung xa|xa trung xa
trung xuan|xa trung xuan
trung yen|xa trung yen
truong an|phuong truong an
truong chinh|phuong truong chinh
truong dinh|phuong truong dinh
truong dong|xa truong dong
truong giang|xa truong giang
truong ha|xa truong ha
truong hoa|xa truong hoa
truong khanh|xa truong khanh
truong lac|phuong truong lac
truong lam|xa truong lam
truong long a|xa truong long a
truong long hoa|xa truong long hoa
truong long tay|xa truong long tay
truong long|xa truong long
truong luong|xa truong luong
truong minh|xa truong minh
truong mit|xa truong mit
truong quang trong|phuong truong quang trong
truong sa|thi tran truong sa
truong sinh|xa truong sinh
truong son|phuong truong son
truong son|thi tran truong son
truong son|xa truong son
truong tay|xa truong tay
truong thang|xa truong thang
truong thanh|phuong truong thanh
truong thanh|xa truong thanh
truong thinh|xa truong thinh
truong thi|phuong truong thi
truong tho|phuong truong tho
truong tho|xa truong tho
truong thuy|xa truong thuy
truong trung|xa truong trung
truong xuan a|xa truong xuan a
truong xuan b|xa truong xuan b
truong xuan|phuong truong xuan
truong xuan|xa truong xuan
truong yen|xa truong yen
tu an|phuong tu an
tu an|xa tu an
tu cuong|xa tu cuong
tu dan|xa tu dan
tu doan|xa tu doan
tu do|xa tu do
tu du|xa tu du
tu ha|phuong tu ha
tu hiep|xa tu hiep
tu ky|thi tran tu ky
tu lan|xa tu lan
tu lap|xa tu lap
tu le|xa tu le
tu lien|phuong tu lien
tu ly|xa tu ly
tu mai|xa tu mai
tu mich|xa tu mich
tu minh|phuong tu minh
tu mo rong|xa tu mo rong
tu nang|xa tu nang
tu ne|xa tu ne
tu nhan|xa tu nhan
tu nhien|xa tu nhien
tu quan|xa tu quan
tu son|xa tu son
tu tan|xa tu tan
tu thinh|xa tu thinh
tu tra|xa tu tra
tu trung|thi tran tu trung
tu vu|xa tu vu
tu xa|xa tu xa
tu xuyen|xa tu xuyen
tu yen|xa tu yen
tua chua|thi tran tua chua
tua sin chai|xa tua sin chai
tua thang|xa tua thang
tuan chau|phuong tuan chau
tuan chinh|xa tuan chinh
tuan dao|xa tuan dao
tuan giao|thi tran tuan giao
tuan tuc|xa tuan tuc
tuan viet|xa tuan viet
tuc dan|xa tuc dan
tuc duyen|phuong tuc duyen
tuc tranh|xa tuc tranh
tuc trung|xa tuc trung
tung anh|xa tung anh
tung ba|xa tung ba
tung chau|xa tung chau
tung chung pho|xa tung chung pho
tung khe|xa tung khe
tung lam|xa tung lam
tung loc|xa tung loc
tung san|xa tung san
tung vai|xa tung vai
tuong binh hiep|phuong tuong binh hiep
tuong da|xa tuong da
tuong giang|xa tuong giang
tuong ha|xa tuong ha
tuong linh|xa tuong linh
tuong loc|xa tuong loc
tuong mai|phuong tuong mai
tuong phong|xa tuong phong
tuong phu|xa tuong phu
tuong son|xa tuong son
tuong thuong|xa tuong thuong
tuong tien|xa tuong tien
tuong van|xa tuong van
tuy lai|xa tuy lai
tuy loc|xa tuy loc
tuy phuoc|thi tran tuy phuoc
tuyen binh tay|xa tuyen binh tay
tuyen binh|xa tuyen binh
tuyen thanh|xa tuyen thanh
tuyet nghia|xa tuyet nghia
u minh|thi tran u minh
uc ky|xa uc ky
ung hoe|xa ung hoe
uy no|xa uy no
uyen hung|phuong uyen hung
vam lang|thi tran vam lang
van am|xa van am
van an|phuong van an
van an|xa van an
van ban|xa van ban
van binh|xa van binh
van cam|xa van cam
van canh|thi tran van canh
van canh|xa van canh
van chai|xa van chai
van chuong|phuong van chuong
van con|xa van con
van co|phuong van co
van dau|phuong van dau
van diem|xa van diem
van dien|thi tran van dien
van dinh|thi tran van dinh
van don|xa van don
van duc|phuong van duc
van duc|xa van duc
van duong|phuong van duong
van du|thi tran van du
van du|xa van du
van giang|phuong van giang
van giang|thi tran van giang
van giao|xa van giao
van gia|thi tran van gia
van hai|phuong van hai
van hai|xa van hai
van han|xa van han
van ha|xa van ha
van hoang|xa van hoang
van hoa|xa van hoa
van hoi|xa van hoi
van ho|xa van ho
van hung|xa van hung
van huong|phuong van huong
van khanh dong|xa van khanh dong
van khanh tay|xa van khanh tay
van khanh|xa van khanh
van khe|xa van khe
van khuc|xa van khuc
van kim|xa van kim
van lang|xa van lang
van lem|xa van lem
van linh|xa van linh
van loi|xa van loi
van long|xa van long
van lung|xa van lung
van luong|xa van luong
van ly|xa van ly
van mai|xa van mai
van mieu|phuong van mieu
van mieu|xa van mieu
van minh|xa van minh
van mon|xa van mon
van my|phuong van my
van nam|xa van nam
van nghia|xa van nghia
van nham|xa van nham
van nho|xa van nho
van nhue|xa van nhue
van ninh|xa van ninh
van noi|xa van noi
van phai|xa van phai
van phong|xa van phong
van phuc|phuong van phuc
van phuc|xa van phuc
van phuoc|xa van phuoc
van phuong|xa van phuong
van phu|phuong van phu
van phu|xa van phu
van quan|phuong van quan
van quan|thi tran van quan
van quan|xa van quan
van son|xa van son
van tao|xa van tao
van thai|xa van thai
van thang|phuong van thang
van thang|xa van thang
van thanh|phuong van thanh
van thanh|xa van thanh
van thien|xa van thien
van tho|xa van tho
van thuy|xa van thuy
van tien|xa van tien
van to|xa van to
van trach|xa van trach
van trinh|xa van trinh
van truc|xa van truc
van trung|xa van trung
van truong|xa van truong
van tung|xa van tung
van tu|xa van tu
van vo|xa van vo
van vu|xa van vu
van xa|xa van xa
van xuan|xa van xuan
van xuoi|xa van xuoi
van yen|phuong van yen
van yen|xa van yen
vang danh|phuong vang danh
vang dan|xa vang dan
vang ma chai|xa vang ma chai
vang quoi dong|xa vang quoi dong
vang quoi tay|xa vang quoi tay
vang san|xa vang san
vat lai|xa vat lai
vay nua|xa vay nua
ve an|phuong ve an
vi binh|xa vi binh
vi da|phuong vi da
vi dong|xa vi dong
vi hoang|phuong vi hoang
vi huong|xa vi huong
vi tan|xa vi tan
vi thang|xa vi thang
vi thanh|xa vi thanh
vi thuong|xa vi thuong
vi thuy|xa vi thuy
vi trung|xa vi trung
vi xuyen|phuong vi xuyen
vi xuyen|thi tran vi xuyen
vien an dong|xa vien an dong
vien an|xa vien an
vien binh|xa vien binh
vien noi|xa vien noi
vien son|phuong vien son
vien son|xa vien son
vien thanh|xa vien thanh
vieng lan|xa vieng lan
viet cuong|xa viet cuong
viet dan|xa viet dan
viet doan|xa viet doan
viet hai|xa viet hai
viet hoa|phuong viet hoa
viet hoa|xa viet hoa
viet hong|xa viet hong
viet hung|phuong viet hung
viet hung|xa viet hung
viet lam|xa viet lam
viet lap|xa viet lap
viet long|xa viet long
viet ngoc|xa viet ngoc
viet quang|thi tran viet quang
viet thang|xa viet thang
viet thanh|xa viet thanh
viet thong|xa viet thong
viet thuan|xa viet thuan
viet tien|xa viet tien
viet vinh|xa viet vinh
viet xuan|xa viet xuan
vinh an|thi tran vinh an
vinh an|xa vinh an
vinh bao|phuong vinh bao
vinh bao|thi tran vinh bao
vinh binh bac|xa vinh binh bac
vinh binh nam|xa vinh binh nam
vinh binh|thi tran vinh binh
vinh binh|xa vinh binh
vinh buu|xa vinh buu
vinh chanh|xa vinh chanh
vinh chan|xa vinh chan
vinh chap|xa vinh chap
vinh chau a|xa vinh chau a
vinh chau b|xa vinh chau b
vinh chau|xa vinh chau
vinh cong|xa vinh cong
vinh dai|xa vinh dai
vinh dien|phuong vinh dien
vinh dieu|xa vinh dieu
vinh dong|xa vinh dong
vinh giang|xa vinh giang
vinh gia|xa vinh gia
vinh hai|phuong vinh hai
vinh hai|xa vinh hai
vinh hanh|xa vinh hanh
vinh hao|xa vinh hao
vinh hau a|xa vinh hau a
vinh hau|xa vinh hau
vinh ha|xa vinh ha
vinh hien|xa vinh hien
vinh hiep|phuong vinh hiep
vinh hiep|xa vinh hiep
vinh hoa hiep|xa vinh hoa hiep
vinh hoa hung bac|xa vinh hoa hung bac
vinh hoa hung nam|xa vinh hoa hung nam
vinh hoa phu|xa vinh hoa phu
vinh hoa|phuong vinh hoa
vinh hoa|xa vinh hoa
vinh hoi dong|xa vinh hoi dong
vinh hong|xa vinh hong
vinh hung a|xa vinh hung a
vinh hung|phuong vinh hung
vinh hung|thi tran vinh hung
vinh hung|xa vinh hung
vinh huu|xa vinh huu
vinh khanh|xa vinh khanh
vinh khe|xa vinh khe
vinh khuc|xa vinh khuc
vinh kien|xa vinh kien
vinh kim|xa vinh kim
vinh lac|phuong vinh lac
vinh lac|xa vinh lac
vinh lai|xa vinh lai
vinh lam|xa vinh lam
vinh lap|xa vinh lap
vinh loc a|xa vinh loc a
vinh loc b|xa vinh loc b
vinh loc|thi tran vinh loc
vinh loc|xa vinh loc
vinh loi|phuong vinh loi
vinh loi|xa vinh loi
vinh long|xa vinh long
vinh luong|xa vinh luong
vinh my a|xa vinh my a
vinh my b|xa vinh my b
vinh my|phuong vinh my
vinh my|xa vinh my
vinh ngoc|xa vinh ngoc
vinh nguon|phuong vinh nguon
vinh nguyen|phuong vinh nguyen
vinh nhuan|xa vinh nhuan
vinh niem|phuong vinh niem
vinh ninh|phuong vinh ninh
vinh ninh|xa vinh ninh
vinh o|xa vinh o
vinh phong|xa vinh phong
vinh phu dong|xa vinh phu dong
vinh phu tay|xa vinh phu tay
vinh phuc|phuong vinh phuc
vinh phuc|xa vinh phuc
vinh phuoc a|xa vinh phuoc a
vinh phuoc b|xa vinh phuoc b
vinh phuoc|phuong vinh phuoc
vinh phuoc|xa vinh phuoc
vinh phuong|xa vinh phuong
vinh phu|phuong vinh phu
vinh phu|xa vinh phu
vinh quang|phuong vinh quang
vinh quang|thi tran vinh quang
vinh quang|xa vinh quang
vinh quoi|xa vinh quoi
vinh quynh|xa vinh quynh
vinh quy|xa vinh quy
vinh son|xa vinh son
vinh tan|phuong vinh tan
vinh tan|xa vinh tan
vinh te|xa vinh te
vinh thai|xa vinh thai
vinh thang|xa vinh thang
vinh thanh trung|xa vinh thanh trung
vinh thanh van|phuong vinh thanh van
vinh thanh|phuong vinh thanh
vinh thanh|thi tran vinh thanh
vinh thanh|xa vinh thanh
vinh thinh|xa vinh thinh
vinh thoi|xa vinh thoi
vinh thong|phuong vinh thong
vinh tho|phuong vinh tho
vinh thuan dong|xa vinh thuan dong
vinh thuan tay|xa vinh thuan tay
vinh thuan|thi tran vinh thuan
vinh thuan|xa vinh thuan
vinh thuc|xa vinh thuc
vinh thuy|xa vinh thuy
vinh tien|xa vinh tien
vinh trach dong|xa vinh trach dong
vinh trach|xa vinh trach
vinh trai|phuong vinh trai
vinh trinh|xa vinh trinh
vinh tri|xa vinh tri
vinh trung|phuong vinh trung
vinh trung|xa vinh trung
vinh truong|phuong vinh truong
vinh truong|xa vinh truong
vinh tru|thi tran vinh tru
vinh tuong|phuong vinh tuong
vinh tuong|thi tran vinh tuong
vinh tuong|xa vinh tuong
vinh tuy|phuong vinh tuy
vinh tuy|thi tran vinh tuy
vinh tuy|xa vinh tuy
vinh tu|xa vinh tu
vinh vien a|xa vinh vien a
vinh vien|thi tran vinh vien
vinh xa|xa vinh xa
vinh xuan|xa vinh xuan
vinh xuong|xa vinh xuong
vinh yen|xa vinh yen
vo cuong|phuong vo cuong
vo diem|xa vo diem
vo lao|xa vo lao
vo liet|xa vo liet
vo mieu|xa vo mieu
vo ngai|xa vo ngai
vo ninh|xa vo ninh
vo tranh|xa vo tranh
vo xu|thi tran vo xu
vong dong|xa vong dong
vong la|xa vong la
vong the|xa vong the
vong xuyen|xa vong xuyen
vu an|xa vu an
vu ban|thi tran vu ban
vu ban|xa vu ban
vu binh|xa vu binh
vu bon|xa vu bon
vu chan|xa vu chan
vu chinh|xa vu chinh
vu cong|xa vu cong
vu di|xa vu di
vu doai|xa vu doai
vu dong|xa vu dong
vu hoa|xa vu hoa
vu hoi|xa vu hoi
vu lac|xa vu lac
vu lang|xa vu lang
vu le|xa vu le
vu linh|xa vu linh
vu minh|xa vu minh
vu muon|xa vu muon
vu ninh|phuong vu ninh
vu ninh|xa vu ninh
vu nong|xa vu nong
vu oai|xa vu oai
vu phuc|xa vu phuc
vu quang|thi tran vu quang
vu quang|xa vu quang
vu qui|xa vu qui
vu son|xa vu son
vu thang|xa vu thang
vu thu|thi tran vu thu
vu tien|xa vu tien
vu trung|xa vu trung
vu van|xa vu van
vu vinh|xa vu vinh
vu xa|xa vu xa
vung liem|thi tran vung liem
vuong loc|xa vuong loc
xa ayun
xa b'la|bla
xa ba
xa bang|xa xa bang
xa ch'om|chom
xa dang
xa dong
xa dun
xa dung|xa xa dung
xa eabar
xa eabia
xa ealy
xa eatrol
xa gao
xa glar
xa h'neng|hneng
xa hieu
xa hnol
xa ho|xa xa ho
xa hra
xa huc
xa k'dang|kdang
xa krong
xa kroong
xa laee
xa lang
xa lat
xa lia
xa luong|xa xa luong
xa ly|xa xa ly
xa phan
xa phien|xa xa phien
xa phin|xa xa phin
xa pro
xa sro
xa thanh
xa thuan
xa tong|xa xa tong
xa tr'hy|trhy
xa trang
xa tu
xa uar
xa xop
xa xy
xa zuoich
xich tho|xa xich tho
xieng my|xa xieng my
xim vang|xa xim vang
xin cai|xa xin cai
xin chai|xa xin chai
xin man|xa xin man
xuan ai|xa xuan ai
xuan ang|xa xuan ang
xuan an|phuong xuan an
xuan an|thi tran xuan an
xuan an|xa xuan an
xuan bac|xa xuan bac
xuan bai|xa xuan bai
xuan bao|xa xuan bao
xuan binh|phuong xuan binh
xuan binh|xa xuan binh
xuan cam|xa xuan cam
xuan canh|xa xuan canh
xuan cao|xa xuan cao
xuan chau|xa xuan chau
xuan chinh|xa xuan chinh
xuan dai|phuong xuan dai
xuan dai|xa xuan dai
xuan dam|xa xuan dam
xuan dinh|phuong xuan dinh
xuan dinh|xa xuan dinh
xuan dong|xa xuan dong
xuan duc|xa xuan duc
xuan duong|xa xuan duong
xuan du|xa xuan du
xuan giang|xa xuan giang
xuan giao|xa xuan giao
xuan hai|xa xuan hai
xuan ha|phuong xuan ha
xuan hiep|xa xuan hiep
xuan hoa|phuong xuan hoa
xuan hoa|thi tran xuan hoa
xuan hoa|xa xuan hoa
xuan hoi|xa xuan hoi
xuan hong|xa xuan hong
xuan hung|xa xuan hung
xuan huong|xa xuan huong
xuan huy|xa xuan huy
xuan khang|xa xuan khang
xuan khanh|phuong xuan khanh
xuan khe|xa xuan khe
xuan kien|xa xuan kien
xuan lac|xa xuan lac
xuan lai|xa xuan lai
xuan lam|phuong xuan lam
xuan lam|xa xuan lam
xuan lanh|xa xuan lanh
xuan lao|xa xuan lao
xuan lap|phuong xuan lap
xuan lap|xa xuan lap
xuan la|phuong xuan la
xuan la|xa xuan la
xuan le|xa xuan le
xuan lien|xa xuan lien
xuan linh|xa xuan linh
xuan loc|xa xuan loc
xuan loi|xa xuan loi
xuan long|xa xuan long
xuan lung|xa xuan lung
xuan luong|xa xuan luong
xuan mai|thi tran xuan mai
xuan minh|xa xuan minh
xuan my|xa xuan my
xuan ngoc|xa xuan ngoc
xuan nha|xa xuan nha
xuan ninh|xa xuan ninh
xuan noi|xa xuan noi
xuan non|xa xuan non
xuan phong|xa xuan phong
xuan pho|xa xuan pho
xuan phuc|xa xuan phuc
xuan phuoc|xa xuan phuoc
xuan phuong|phuong xuan phuong
xuan phuong|xa xuan phuong
xuan phu|phuong xuan phu
xuan phu|xa xuan phu
xuan quang 1|xa xuan quang 1
xuan quang 2|xa xuan quang 2
xuan quang 3|xa xuan quang 3
xuan quang|xa xuan quang
xuan quan|xa xuan quan
xuan que|xa xuan que
xuan sinh|xa xuan sinh
xuan son bac|xa xuan son bac
xuan son nam|xa xuan son nam
xuan son|phuong xuan son
xuan son|xa xuan son
xuan tam|xa xuan tam
xuan tang|phuong xuan tang
xuan tan|phuong xuan tan
xuan tan|xa xuan tan
xuan tao|phuong xuan tao
xuan tay|xa xuan tay
xuan thai|xa xuan thai
xuan thang|xa xuan thang
xuan thanh|phuong xuan thanh
xuan thanh|xa xuan thanh
xuan thien|xa xuan thien
xuan thinh|xa xuan thinh
xuan tho 1|xa xuan tho 1
xuan tho 2|xa xuan tho 2
xuan thoi dong|xa xuan thoi dong
xuan thoi son|xa xuan thoi son
xuan thoi thuong|xa xuan thoi thuong
xuan tho|xa xuan tho
xuan thuong|xa xuan thuong
xuan thuy|xa xuan thuy
xuan thu|xa xuan thu
xuan tien|xa xuan tien
xuan tin|xa xuan tin
xuan trach|xa xuan trach
xuan truc|xa xuan truc
xuan trung|phuong xuan trung
xuan trung|xa xuan trung
xuan truong|thi tran xuan truong
xuan truong|xa xuan truong
xuan tuong|xa xuan tuong
xuan van|xa xuan van
xuan vien|xa xuan vien
xuan vinh|xa xuan vinh
xuan yen|phuong xuan yen
xuan yen|xa xuan yen
xuat hoa|phuong xuat hoa
xuat hoa|xa xuat hoa
xuat le|xa xuat le
xuong giang|phuong xuong giang
xuong huan|phuong xuong huan
xuong lam|xa xuong lam
xuong thinh|xa xuong thinh
xuy xa|xa xuy xa
xuyen moc|xa xuyen moc
y can|xa y can
y la|phuong y la
y tich|xa y tich
y ty|xa y ty
ya hoi|xa ya hoi
ya ly|xa ya ly
ya ma|xa ya ma
ya tang|xa ya tang
ya to mot|xa ya to mot
ya xier|xa ya xier
yang bac|xa yang bac
yang mao|xa yang mao
yang nam|xa yang nam
yang reh|xa yang reh
yang tao|xa yang tao
yang trung|xa yang trung
yen bac|phuong yen bac
yen bai|xa yen bai
yen bang|xa yen bang
yen binh|phuong yen binh
yen binh|thi tran yen binh
yen binh|xa yen binh
yen bong|xa yen bong
yen cat|thi tran yen cat
yen chau|thi tran yen chau
yen chinh|xa yen chinh
yen cuong|xa yen cuong
yen cu|xa yen cu
yen dinh|thi tran yen dinh
yen dinh|xa yen dinh
yen dong|xa yen dong
yen do|phuong yen do
yen do|xa yen do
yen duc|xa yen duc
yen duong|xa yen duong
yen giang|phuong yen giang
yen gia|xa yen gia
yen hai|phuong yen hai
yen han|xa yen han
yen ha|xa yen ha
yen hoa|phuong yen hoa
yen hoa|xa yen hoa
yen hong|xa yen hong
yen hop|xa yen hop
yen ho|xa yen ho
yen hung|xa yen hung
yen khang|xa yen khang
yen khanh|xa yen khanh
yen khe|xa yen khe
yen khoai|xa yen khoai
yen khuong|xa yen khuong
yen kien|xa yen kien
yen ky|xa yen ky
yen lac|thi tran yen lac
yen lac|xa yen lac
yen lam|xa yen lam
yen lang|xa yen lang
yen lap|thi tran yen lap
yen lap|xa yen lap
yen loc|xa yen loc
yen loi|xa yen loi
yen lo|xa yen lo
yen luat|xa yen luat
yen luong|xa yen luong
yen lu|xa yen lu
yen mac|xa yen mac
yen minh|thi tran yen minh
yen minh|xa yen minh
yen mong|xa yen mong
yen my|thi tran yen my
yen my|xa yen my
yen nam|xa yen nam
yen na|xa yen na
yen nghia|phuong yen nghia
yen nghia|xa yen nghia
yen nghiep|xa yen nghiep
yen nguyen|xa yen nguyen
yen nhan|xa yen nhan
yen ninh|phuong yen ninh
yen ninh|thi tran yen ninh
yen ninh|xa yen ninh
yen phong|xa yen phong
yen phuc|xa yen phuc
yen phuong|xa yen phuong
yen phu|phuong yen phu
yen phu|thi tran yen phu
yen phu|xa yen phu
yen quang|xa yen quang
yen son|xa yen son
yen so|phuong yen so
yen so|xa yen so
yen tam|xa yen tam
yen tan|xa yen tan
yen tap|xa yen tap
yen thach|xa yen thach
yen thai|xa yen thai
yen thang|xa yen thang
yen thanh|phuong yen thanh
yen thanh|thi tran yen thanh
yen thanh|xa yen thanh
yen than|xa yen than
yen the|phuong yen the
yen the|thi tran yen the
yen thinh|phuong yen thinh
yen thinh|thi tran yen thinh
yen thinh|xa yen thinh
yen tho|phuong yen tho
yen tho|xa yen tho
yen thuan|xa yen thuan
yen thuong|xa yen thuong
yen tien|xa yen tien
yen tinh|xa yen tinh
yen trach|xa yen trach
yen tri|xa yen tri
yen trung|xa yen trung
yen truong|xa yen truong
yen tu|xa yen tu
yen vien|thi tran yen vien
yen vien|xa yen vien
yen vuong|xa yen vuong
yet kieu|phuong yet kieu
yet kieu|xa yet kieu
za hung|xa za hung
