an giang|tinh an giang|tỉnh an giang
ba ria vung tau|ba ria|tinh ba ria vung tau|tinh ba ria|bà rịa vũng tàu|bà rịa|tỉnh bà rịa vũng tàu|tỉnh bà rịa
bac giang|tinh bac giang|bắc giang|tỉnh bắc giang
bac kan|tinh bac kan|bắc kạn|tỉnh bắc kạn
bac lieu|tinh bac lieu|bạc liêu|tỉnh bạc liêu
bac ninh|tinh bac ninh|bắc ninh|tỉnh bắc ninh
ben tre|tinh ben tre|bến tre|tỉnh bến tre
binh dinh|tinh binh dinh|bình định|tỉnh bình định
binh duong|tinh binh duong|bình dương|tỉnh bình dương
binh phuoc|tinh binh phuoc|bình phước|tỉnh bình phước
binh thuan|tinh binh thuan|bình thuận|tỉnh bình thuận
ca mau|tinh ca mau|cà mau|tỉnh cà mau
can tho|thanh pho can tho|tp can tho|tp. can tho|cần thơ|thành phố cần thơ|tp cần thơ|tp. cần thơ
cao bang|tinh cao bang|cao bằng|tỉnh cao bằng
da nang|thanh pho da nang|tp da nang|tp. da nang|đà nẵng|thành phố đà nẵng|tp đà nẵng|tp. đà nẵng
dak lak|tinh dak lak|đắk lắk|tỉnh đắk lắk
dak nong|tinh dak nong|đắk nông|tỉnh đắk nông
dien bien|tinh dien bien|điện biên|tỉnh điện biên
dong nai|tinh dong nai|đồng nai|tỉnh đồng nai
dong thap|tinh dong thap|đồng tháp|tỉnh đồng tháp
gia lai|tinh gia lai|tỉnh gia lai
ha giang|tinh ha giang|hà giang|tỉnh hà giang
ha nam|tinh ha nam|hà nam|tỉnh hà nam
ha noi|tp ha noi|tp. ha noi|thanh pho ha noi|hn|tp hn|tp. hn|thanh pho hn|thu do ha noi|hà nội|tp. hà nội|thành phố hà nội|thành phố hn|thủ đô hà nội
ha tinh|tinh ha tinh|hà tĩnh|tỉnh hà tĩnh
hai duong|tinh hai duong|hải dương|tỉnh hải dương
hai phong|thanh pho hai phong|tp hai phong|tp. hai phong|hải phòng|thành phố hải phòng|tp hải phòng|tp. hải phòng
hau giang|tinh hau giang|hậu giang|tỉnh hậu giang
ho chi minh|tp ho chi minh|tp. ho chi minh|thanh pho ho chi minh|hcm|tp hcm|tp. hcm|thanh pho hcm|hồ chí minh|tp. hồ chí minh|thành phố hồ chí minh|thành phố hcm
hoa binh|tinh hoa binh|hoà bình|tỉnh hoà bình
hung yen|tinh hung yen|hưng yên|tỉnh hưng yên
khanh hoa|tinh khanh hoa|khánh hòa|tỉnh khánh hòa
kien giang|tinh kien giang|kiên giang|tỉnh kiên giang
kon tum|tinh kon tum|tỉnh kon tum
lai chau|tinh lai chau|lai châu|tỉnh lai châu
lam dong|tinh lam dong|lâm đồng|tỉnh lâm đồng
lang son|tinh lang son|lạng sơn|tỉnh lạng sơn
lao cai|tinh lao cai|lào cai|tỉnh lào cai
long an|tinh long an|tỉnh long an
nam dinh|tinh nam dinh|nam định|tỉnh nam định
nghe an|tinh nghe an|nghệ an|tỉnh nghệ an
ninh binh|tinh ninh binh|ninh bình|tỉnh ninh bình
ninh thuan|tinh ninh thuan|ninh thuận|tỉnh ninh thuận
phu tho|tinh phu tho|phú thọ|tỉnh phú thọ
phu yen|tinh phu yen|phú yên|tỉnh phú yên
quang binh|tinh quang binh|quảng bình|tỉnh quảng bình
quang nam|tinh quang nam|quảng nam|tỉnh quảng nam
quang ngai|tinh quang ngai|quảng ngãi|tỉnh quảng ngãi
quang ninh|tinh quang ninh|quảng ninh|tỉnh quảng ninh
quang tri|tinh quang tri|quảng trị|tỉnh quảng trị
soc trang|tinh soc trang|sóc trăng|tỉnh sóc trăng
son la|tinh son la|sơn la|tỉnh sơn la
tay ninh|tinh tay ninh|tây ninh|tỉnh tây ninh
thai binh|tinh thai binh|thái bình|tỉnh thái bình
thai nguyen|tinh thai nguyen|thái nguyên|tỉnh thái nguyên
thanh hoa|tinh thanh hoa|thanh hóa|tỉnh thanh hóa
thua thien hue|tinh thua thien hue|thừa thiên huế|tỉnh thừa thiên huế
tien giang|tinh tien giang|tiền giang|tỉnh tiền giang
tra vinh|tinh tra vinh|trà vinh|tỉnh trà vinh
tuyen quang|tinh tuyen quang|tuyên quang|tỉnh tuyên quang
vinh long|tinh vinh long|vĩnh long|tỉnh vĩnh long
vinh phuc|tinh vinh phuc|vĩnh phúc|tỉnh vĩnh phúc
yen bai|tinh yen bai|yên bái|tỉnh yên bái
